Type,Product,Date,Description,Amount,Balance,Hide
CARD_PAYMENT,Current,2025-04-30 08:47:21,Civis Cafe Canteen,-350.0,27865.91,False
CARD_PAYMENT,Current,2025-04-30 07:54:29,1605021531 Gfa It,-500.0,27365.91,False
CARD_PAYMENT,Current,2025-04-30 13:46:05,Coop,-1237.0,26128.91,False
CARD_PAYMENT,Current,2025-04-30 15:48:36,Simple,-1297.0,24831.91,False
CARD_PAYMENT,Current,2025-05-01 12:29:37,Viger Katalin E.v.,-700.0,24131.91,False
TOPUP,Current,2025-05-01 21:55:08,Top-Up by *7109,6000.0,30131.91,False
TRANSFER,Current,2025-05-02 18:20:15,Transfer from Revolut user,5200.0,35331.91,False
CARD_PAYMENT,Current,2025-05-01 21:59:59,Steam,-6028.37,29303.54,False
CARD_PAYMENT,Current,2025-05-02 12:47:33,Sostozoo,-15600.0,13703.54,False
CARD_PAYMENT,Current,2025-04-29 17:59:24,HELL Energy,-430.0,13273.54,False
TRANSFER,Current,2025-05-03 10:27:34,Transfer from Revolut user,1266.68,14540.22,False
TRANSFER,Current,2025-05-03 10:30:05,Transfer to Revolut user,-1266.0,13274.22,False
CARD_PAYMENT,Current,2025-05-02 16:03:51,Cocacolahbcmagyaror,-700.0,12574.22,False
CARD_PAYMENT,Current,2025-05-02 16:05:10,Cocacolahbcmagyaror,-700.0,11874.22,False
CARD_PAYMENT,Current,2025-05-02 18:22:41,KFC,-6310.0,5564.22,False
TRANSFER,Current,2025-05-04 11:15:42,To HUF,20000.0,25564.22,False
CARD_PAYMENT,Current,2025-05-04 11:19:53,Apple,-4490.0,21074.22,False
EXCHANGE,Current,2025-05-05 11:41:50,Exchange to HUF,509033.83,528457.43,False
TRANSFER,Current,2025-05-05 11:42:13,Transfer to Revolut user,-305000.0,223457.43,False
TRANSFER,Current,2025-05-05 11:43:25,Zéti Polgári,-200000.0,22057.43,False
TOPUP,Current,2025-05-05 11:48:54,Top-Up by *7109,4500.0,26557.43,False
CARD_PAYMENT,Current,2025-05-04 10:55:24,Vitaminkucko,-3719.0,22838.43,False
CARD_PAYMENT,Current,2025-05-05 15:09:48,Nemzeti Dohánybolt,-688.0,22150.43,False
CARD_PAYMENT,Current,2025-05-05 16:50:01,Both-Dega Büfe,-1500.0,20650.43,False
CARD_PAYMENT,Current,2025-05-05 15:38:05,Simple,-989.0,19661.43,False
TRANSFER,Current,2025-05-07 15:12:35,Transfer to Revolut user,-12000.0,7661.43,False
CARD_PAYMENT,Current,2025-05-07 07:48:07,Civis Cafe Canteen,-1400.0,6261.43,False
TRANSFER,Current,2025-05-08 17:33:16,Transfer from Revolut user,12000.0,18261.43,False
TRANSFER,Current,2025-05-08 17:33:37,Anett Moldován,-12000.0,6177.43,False
TOPUP,Current,2025-05-09 09:57:36,Top-Up by *7109,200000.0,206177.43,False
TRANSFER,Current,2025-05-09 09:59:19,To HUF Holidays,-20000.0,186177.43,False
TRANSFER,Current,2025-05-09 10:00:18,To Savings Account,-30000.0,156177.43,False
TRANSFER,Current,2025-05-09 10:02:12,To HUF Rainy day,-60000.0,96177.43,False
TRANSFER,Current,2025-05-10 20:03:56,Transfer from Revolut user,7500.0,103677.43,False
CARD_PAYMENT,Current,2025-05-10 20:03:59,Wolt,-7835.3,95842.13,False
CARD_PAYMENT,Current,2025-05-10 16:55:58,Simple,-325.0,95517.13,False
CARD_PAYMENT,Current,2025-05-11 11:13:39,Nagy Beki Pekseg,-850.0,94667.13,False
CARD_PAYMENT,Current,2025-05-12 17:45:39,Annuska fagylaltbisztró és kávézó,-3330.0,91337.13,False
CARD_PAYMENT,Current,2025-05-12 19:53:01,Reál,-1957.0,89380.13,False
CARD_PAYMENT,Current,2025-05-12 17:01:51,dm drogerie,-2499.0,86881.13,False
CARD_PAYMENT,Current,2025-05-12 16:43:53,Crunchyroll,-2450.0,84431.13,False
TRANSFER,Current,2025-05-13 20:20:49,LEVENTE NANDOR POLGARI,-30000.0,54221.13,False
CARD_PAYMENT,Current,2025-05-13 23:51:31,Notino,-4020.0,50201.13,False
CARD_PAYMENT,Current,2025-05-13 17:51:45,Simple,-209.0,49992.13,False
CARD_PAYMENT,Current,2025-05-13 12:06:18,NAV,-5771.0,44221.13,False
CARD_PAYMENT,Current,2025-05-14 07:39:03,Civis Cafe Canteen,-1850.0,42371.13,False
TRANSFER,Current,2025-05-15 13:04:10,To HUF,75000.0,117371.13,False
TRANSFER,Current,2025-05-16 08:45:35,Transfer from Revolut user,35800.0,153171.13,False
TRANSFER,Current,2025-05-16 08:48:15,Transfer from Revolut user,10000.0,163171.13,False
TRANSFER,Current,2025-05-16 08:48:30,Anett Moldován,-10000.0,153101.13,False
CARD_PAYMENT,Current,2025-05-15 13:05:40,Ryanair,-73952.0,79149.13,False
TRANSFER,Current,2025-05-16 16:37:07,Anett Moldován,-2000.0,77135.13,False
CARD_PAYMENT,Current,2025-05-16 17:06:21,MOL,-24397.0,52738.13,False
CARD_PAYMENT,Current,2025-05-16 15:55:45,Simple,-550.0,52188.13,False
CARD_PAYMENT,Current,2025-05-18 22:57:15,Spotify,-1090.0,51098.13,False
TRANSFER,Current,2025-05-19 11:09:04,LEVENTE NANDOR POLGARI,-5000.0,46063.13,False
CARD_PAYMENT,Current,2025-05-18 19:40:04,Nemzeti Dohánybolt,-1700.0,44363.13,False
TRANSFER,Current,2025-05-21 07:57:57,Transfer from Revolut user,50000.0,94363.13,False
TRANSFER,Current,2025-05-21 08:01:00,Anett Moldován,-49500.0,44516.63,False
CARD_PAYMENT,Current,2025-05-20 10:43:33,Debreceni Egyetem,-440.0,44076.63,False
CARD_PAYMENT,Current,2025-05-21 09:15:12,Civis Cafe Canteen,-1374.0,42702.63,False
TRANSFER,Current,2025-05-22 08:55:41,To HUF,108000.0,150702.63,False
CARD_PAYMENT,Current,2025-05-21 09:25:08,1605021531 Gfa It,-550.0,150152.63,False
TRANSFER,Current,2025-05-22 14:24:12,To HUF Holidays,-105000.0,45152.63,False
TRANSFER,Current,2025-05-22 14:24:54,To HUF,3000.0,48152.63,False
TRANSFER,Current,2025-05-22 14:25:04,To HUF Holidays,-6000.0,42152.63,False
TRANSFER,Current,2025-05-22 22:42:27,To HUF,50000.0,92152.63,False
TRANSFER,Current,2025-05-22 22:48:27,To HUF,15000.0,107152.63,False
CARD_PAYMENT,Current,2025-05-23 18:22:46,KFC,-4580.0,102572.63,False
TRANSFER,Current,2025-05-24 11:56:23,Transfer from Revolut user,2042.7,104615.33,False
TRANSFER,Current,2025-05-24 14:55:50,Transfer to Revolut user,-1000.0,103615.33,False
TRANSFER,Current,2025-05-24 14:56:21,LEVENTE NANDOR POLGARI,-3000.0,100594.33,False
TOPUP,Current,2025-05-24 14:56:42,Top-Up by *7109,5500.0,106094.33,False
TRANSFER,Current,2025-05-24 22:05:11,Mark Fodor,-5000.0,101059.33,False
CARD_PAYMENT,Current,2025-05-24 08:59:38,Apple,-6190.0,94869.33,False
TRANSFER,Current,2025-05-25 11:50:21,To HUF,60000.0,154869.33,False
CARD_PAYMENT,Current,2025-05-24 17:55:58,Líra,-3591.0,151278.33,False
CARD_PAYMENT,Current,2025-05-24 14:47:40,Apolló Mozi,-3300.0,147978.33,False
TOPUP,Current,2025-05-26 11:39:11,Top-Up by *7109,20000.0,167978.33,False
CARD_PAYMENT,Current,2025-05-25 16:56:50,Vitaminkucko,-1027.0,166951.33,False
CARD_PAYMENT,Current,2025-05-22 22:42:34,Adriagate,-65035.92,101265.05,False
EXCHANGE,Current,2025-05-26 20:49:21,Exchange to HUF,6.35,101271.34,False
TRANSFER,Current,2025-05-27 06:09:07,Transfer from Revolut user,110000.0,211271.34,False
TRANSFER,Current,2025-05-27 08:42:04,Anett Moldován,-109000.0,101508.34,False
CARD_PAYMENT,Current,2025-05-27 12:26:06,1605021531 Gfa It,-550.0,100958.34,False
CARD_PAYMENT,Current,2025-05-28 10:19:26,Arriva,-13781.13,87039.4,False
TRANSFER,Current,2025-05-29 17:38:03,Transfer to Revolut user,-3000.0,84039.4,False
TRANSFER,Current,2025-05-29 18:01:15,Transfer from Revolut user,4000.0,88039.4,False
CARD_PAYMENT,Current,2025-05-29 17:52:49,Wolt,-3049.0,84990.4,False
CARD_PAYMENT,Current,2025-05-29 17:59:26,eduna.hu,-12980.0,72010.4,False
CARD_PAYMENT,Current,2025-05-29 19:55:06,MOB Söröző Kávézó,-6160.0,65850.4,False
CARD_PAYMENT,Current,2025-05-29 21:27:02,MOB Söröző Kávézó,-850.0,65000.4,False
CARD_PAYMENT,Current,2025-05-29 22:23:47,MOB Söröző Kávézó,-1920.0,63080.4,False
CARD_PAYMENT,Current,2025-05-29 19:12:23,Nemzeti Mobilfizetési,-480.0,62600.4,False
CARD_PAYMENT,Current,2025-05-29 18:12:40,Nemzeti Dohánybolt,-2125.0,60475.4,False
CARD_PAYMENT,Current,2025-05-31 21:05:08,Tippmixpro,-1500.0,58975.4,False
CARD_PAYMENT,Current,2025-05-31 19:42:12,KFC,-2490.0,56485.4,False
TRANSFER,Current,2025-06-01 14:34:37,Transfer to Revolut user,-2000.0,54485.4,False
CARD_PAYMENT,Current,2025-05-31 23:10:09,McDonald's,-6040.0,48445.4,False
CARD_PAYMENT,Current,2025-05-31 23:10:56,McDonald's,-4025.0,44420.4,False
CARD_PAYMENT,Current,2025-05-31 23:29:53,Nemzeti Dohánybolt,-899.0,43521.4,False
CARD_PAYMENT,Current,2025-06-01 23:56:58,Epic Games Store,-749.0,42772.4,False
CARD_PAYMENT,Current,2025-06-01 22:18:37,Steam,-369.0,42399.71,False
CARD_PAYMENT,Current,2025-06-03 09:17:38,Simple,-244.0,42155.71,False
CARD_PAYMENT,Current,2025-06-03 07:34:13,HELL Energy,-430.0,41725.71,False
CARD_PAYMENT,Current,2025-06-04 11:37:09,Civis Cafe Canteen,-2376.0,39349.71,False
CARD_PAYMENT,Current,2025-06-04 09:26:49,1605021531 Gfa It,-550.0,38799.71,False
CARD_PAYMENT,Current,2025-06-04 16:36:00,Auchan,-2928.0,35871.71,False
CARD_PAYMENT,Current,2025-06-05 19:53:16,Tippmixpro,-1500.0,34371.71,False
CARD_PAYMENT,Current,2025-06-06 19:25:48,Smash Burger & Beer Bar Debrecen,-5980.0,28391.71,False
CARD_PAYMENT,Current,2025-06-06 18:13:41,Nemzeti Dohánybolt,-2100.0,26291.71,False
TRANSFER,Current,2025-06-07 16:26:17,Transfer from Revolut user,2000.0,28291.71,False
TRANSFER,Current,2025-06-07 16:26:51,Transfer from Revolut user,900.0,29191.71,False
TOPUP,Current,2025-06-07 16:36:02,Top-Up by *7109,4000.0,33191.71,False
CARD_PAYMENT,Current,2025-06-07 16:31:56,Harap Lak,-6270.0,26921.71,False
CARD_PAYMENT,Current,2025-06-07 18:53:13,Harap Lak,-1400.0,25521.71,False
CARD_PAYMENT,Current,2025-06-07 14:11:37,Kerekestelepi Termálfürdő és Kemping,-5400.0,20121.71,False
CARD_PAYMENT,Current,2025-06-08 00:54:12,Tippmixpro,-3000.0,17121.71,False
CARD_PAYMENT,Current,2025-06-08 09:39:35,Tippmixpro,-17121.0,0.71,False
TRANSFER,Current,2025-06-10 09:27:02,From Savings Account,21000.0,21000.71,False
TRANSFER,Current,2025-06-10 09:27:39,Transfer to Revolut user,-20000.0,1000.71,False
TOPUP,Current,2025-06-10 11:11:38,Top-Up by *7109,265000.0,266000.71,False
TRANSFER,Savings,2025-05-04 11:15:42,To HUF,-20000.0,180000.0,False
TRANSFER,Savings,2025-05-09 09:59:19,To HUF Holidays,20000.0,200000.0,False
TRANSFER,Savings,2025-05-09 10:02:12,To HUF Rainy day,60000.0,260000.0,False
TRANSFER,Savings,2025-05-15 13:04:10,To HUF,-75000.0,185000.0,False
TRANSFER,Savings,2025-05-22 08:55:41,To HUF,-108000.0,77000.0,False
TRANSFER,Savings,2025-05-22 14:24:12,To HUF Holidays,105000.0,182000.0,False
TRANSFER,Savings,2025-05-22 14:24:54,To HUF,-3000.0,179000.0,False
TRANSFER,Savings,2025-05-22 14:25:04,To HUF Holidays,6000.0,185000.0,False
TRANSFER,Savings,2025-05-22 22:42:27,To HUF,-50000.0,135000.0,False
TRANSFER,Savings,2025-05-22 22:48:27,To HUF,-15000.0,120000.0,False
TRANSFER,Savings,2025-05-25 11:50:21,To HUF,-60000.0,60000.0,False
TRANSFER,Deposit,2025-05-09 10:00:18,To Savings Account,30000.0,330451.26,False
TRANSFER,Deposit,2025-06-10 09:27:02,From Savings Account,-21000.0,309757.02,False
FEE,Current,2025-01-01 02:06:13,Premium plan fee,-3000.0,100213.04,False
TRANSFER,Current,2025-01-01 17:22:08,Transfer to Revolut user,-100000.0,213.04,False
TRANSFER,Current,2025-01-01 17:24:44,Transfer from Revolut user,995000.0,995213.04,False
EXCHANGE,Current,2025-01-01 17:26:51,Exchange to EUR,-995000.0,213.04,False
TRANSFER,Current,2025-01-01 21:07:33,Transfer from Revolut user,140000.0,140213.04,False
TRANSFER,Current,2025-01-02 09:10:25,To Anett Moldován,-139000.0,240.04,False
TOPUP,Current,2025-01-02 17:47:49,Top-Up by *7109,100000.0,100240.04,False
TRANSFER,Current,2025-01-03 00:44:04,To LEVENTE NANDOR POLGARI,-3000.0,97219.04,False
TOPUP,Current,2025-01-03 00:44:18,Top-Up by *7109,5300.0,102519.04,False
CARD_PAYMENT,Current,2025-01-02 18:16:56,KFC,-2390.0,100129.04,False
TRANSFER,Current,2025-01-04 13:51:19,Transfer to Revolut user,-3700.0,96429.04,False
CARD_PAYMENT,Current,2025-01-03 11:19:35,Magyar Posta,-30970.0,65459.04,False
CARD_PAYMENT,Current,2025-01-03 20:07:39,Bartók Csemege,-2239.0,63220.04,False
CARD_REFUND,Current,2025-01-04 01:00:00,Delfinbúvár,2870.0,66090.04,False
TRANSFER,Current,2025-01-05 14:34:44,Transfer from Revolut user,50000.0,116090.04,False
TRANSFER,Current,2025-01-05 15:16:16,To HUF Dentist,-50000.0,66090.04,False
TOPUP,Current,2025-01-08 12:08:57,Top-Up by *7109,20000.0,86090.04,False
CARD_PAYMENT,Current,2025-01-07 16:42:26,MAXILine Töltőállomás,-10002.0,76088.04,False
CARD_PAYMENT,Current,2025-01-08 17:04:47,Simple,-613.0,75475.04,False
CARD_PAYMENT,Current,2025-01-08 17:53:02,Magyar Posta,-7170.0,68305.04,False
TOPUP,Current,2025-01-10 11:48:42,Top-Up by *7109,241357.0,309662.04,False
TRANSFER,Current,2025-01-10 11:51:41,Transfer from Revolut user,29971.5,339633.54,False
TRANSFER,Current,2025-01-10 23:04:20,Transfer to Revolut user,-60000.0,279633.54,False
TRANSFER,Current,2025-01-10 23:05:18,Transfer from Revolut user,60000.0,339633.54,False
EXCHANGE,Current,2025-01-10 23:06:31,Exchange to EUR,-60000.0,279633.54,False
TRANSFER,Current,2025-01-10 23:13:43,To LEVENTE NANDOR POLGARI,-30000.0,249423.54,False
TOPUP,Current,2025-01-10 23:16:27,Top-Up by *7109,10660.0,260083.54,False
CARD_PAYMENT,Current,2025-01-10 11:39:29,Xiaomi Official,-14490.0,245593.54,False
CARD_PAYMENT,Current,2025-01-10 11:50:28,Airbnb,-59943.0,185650.54,False
CARD_PAYMENT,Current,2025-01-10 12:45:43,ANRO épületdíszétés,-4390.0,181260.54,False
TRANSFER,Current,2025-01-11 17:15:43,Transfer from Revolut user,20000.0,201260.54,False
TOPUP,Current,2025-01-12 18:24:15,Top-Up by *7109,6000.0,207260.54,False
TRANSFER,Current,2025-01-12 18:24:33,Transfer to Revolut user,-6000.0,201260.54,False
TOPUP,Current,2025-01-12 23:45:51,Top-Up by *7109,82280.0,283540.54,False
CARD_PAYMENT,Current,2025-01-12 23:44:21,Alza,-82280.0,201260.54,False
CARD_PAYMENT,Current,2025-01-13 14:23:15,Trading 212,-41686.99,159573.55,False
TOPUP,Current,2025-01-14 15:11:32,Top-Up by *7109,70000.0,229573.55,False
CARD_PAYMENT,Current,2025-01-14 15:32:06,Vir Var Dekor,-3000.0,226573.55,False
CARD_PAYMENT,Current,2025-01-14 17:09:36,Nemzeti Dohánybolt,-1700.0,224873.55,False
CARD_PAYMENT,Current,2025-01-14 12:14:41,Nemzeti Mobilfizetési,-480.0,224393.55,False
CARD_PAYMENT,Current,2025-01-14 13:35:31,Coop,-857.0,223536.55,False
CARD_PAYMENT,Current,2025-01-14 15:15:29,Nemzeti Dohánybolt,-949.0,222587.55,False
TRANSFER,Current,2025-01-15 22:57:46,Transfer from Revolut user,3500.0,226087.55,False
CARD_PAYMENT,Current,2025-01-15 19:56:37,Wolt,-6739.0,219348.55,False
TRANSFER,Current,2025-01-16 17:35:53,To Zéti Polgári,-10000.0,209278.55,False
CARD_PAYMENT,Current,2025-01-16 09:36:44,Civis Cafe Canteen,-115.0,209163.55,False
CARD_PAYMENT,Current,2025-01-17 20:58:14,Wolt,-3729.0,205434.55,False
CARD_PAYMENT,Current,2025-01-17 16:28:00,Nemzeti Dohánybolt,-1800.0,203634.55,False
CARD_PAYMENT,Current,2025-01-17 16:36:30,CBA,-2346.0,201288.55,False
CARD_PAYMENT,Current,2025-01-18 21:57:17,Spotify,-1090.0,200198.55,False
TRANSFER,Current,2025-01-19 20:28:12,Transfer to Revolut user,-2800.0,197398.55,False
TRANSFER,Current,2025-01-19 20:28:34,Transfer to Revolut user,-25000.0,172398.55,False
TRANSFER,Current,2025-01-19 20:28:52,Transfer from Revolut user,25000.0,197398.55,False
TRANSFER,Current,2025-01-19 20:28:59,Transfer from Revolut user,2800.0,200198.55,False
TOPUP,Current,2025-01-20 12:55:43,Top-Up by *7109,450000.0,650198.55,False
TRANSFER,Current,2025-01-20 12:58:03,To HUF Temp,-450000.0,200198.55,False
CARD_PAYMENT,Current,2025-01-19 10:38:57,ALDI,-564.0,199634.55,False
CARD_PAYMENT,Current,2025-01-19 16:07:56,Nemzeti Dohánybolt,-2400.0,197234.55,False
CARD_PAYMENT,Current,2025-01-21 18:33:35,Hamburger Bár,-580.0,196654.55,False
TRANSFER,Current,2025-01-23 11:11:48,Transfer to Revolut user,-15000.0,181654.55,False
TRANSFER,Current,2025-01-23 14:04:54,Transfer from Revolut user,2500.0,184154.55,False
TRANSFER,Current,2025-01-23 14:09:04,To HUF,15000.0,199154.55,False
TRANSFER,Current,2025-01-23 14:22:13,Transfer from Revolut user,2000.0,201154.55,False
CARD_PAYMENT,Current,2025-01-23 14:11:39,Wolt,-5366.4,195788.15,False
TRANSFER,Current,2025-01-24 17:28:59,Transfer to Revolut user,-60000.0,135788.15,False
TRANSFER,Current,2025-01-24 18:27:59,Transfer to Revolut user,-5000.0,130788.15,False
TOPUP,Current,2025-01-24 18:51:06,Top-Up by *7109,65000.0,195788.15,False
CARD_PAYMENT,Current,2025-01-24 08:58:23,Apple,-6190.0,189598.15,False
CARD_PAYMENT,Current,2025-01-24 17:31:18,Nemzeti Mobilfizetési,-560.0,189038.15,False
CARD_PAYMENT,Current,2025-01-24 18:51:55,ALDI,-3861.0,185177.15,False
CARD_PAYMENT,Current,2025-01-24 18:54:37,Nemzeti Dohánybolt,-1800.0,183377.15,False
TRANSFER,Current,2025-01-25 23:13:21,To Zéti Polgári,-77500.0,105334.65,False
CARD_PAYMENT,Current,2025-01-25 12:27:35,Twitch,-2044.41,103269.8,False
CARD_PAYMENT,Current,2025-01-25 12:47:51,Nemzeti Mobilfizetési,-480.0,102789.8,False
TRANSFER,Current,2025-01-26 15:49:28,To HUF,450000.0,552789.8,False
TRANSFER,Current,2025-01-26 15:50:06,To Anett Moldován,-547000.0,1960.8,False
CARD_PAYMENT,Current,2025-01-25 12:57:44,McDonald's,-1490.0,470.8,False
EXCHANGE,Current,2025-01-27 09:10:23,Exchange to HUF,81009.18,81479.98,False
TRANSFER,Current,2025-01-27 23:57:51,Transfer from Revolut user,140000.0,221479.98,False
TRANSFER,Current,2025-01-28 08:46:56,To Anett Moldován,-138500.0,82010.48,False
CARD_PAYMENT,Current,2025-01-27 18:40:18,McDonald's,-2260.0,79750.48,False
CARD_PAYMENT,Current,2025-01-28 15:12:28,Dallmayr,-260.0,79490.48,False
CARD_PAYMENT,Current,2025-01-28 13:33:50,Debreceni Egyetem,-530.0,78960.48,False
CARD_PAYMENT,Current,2025-01-29 17:54:11,Nemzeti Dohánybolt,-2179.0,76781.48,False
FEE,Current,2025-02-01 02:22:59,Premium plan fee,-3000.0,73781.48,False
CARD_PAYMENT,Current,2025-02-04 15:50:58,Amazon Prime,-1900.0,71881.48,False
CARD_PAYMENT,Current,2025-02-06 17:42:12,Nemzeti Dohánybolt,-1088.0,70793.48,False
CARD_PAYMENT,Current,2025-02-05 19:07:07,Steam,-5234.09,65559.39,False
CARD_PAYMENT,Current,2025-02-05 22:09:37,Nemzeti Dohánybolt,-2147.0,63412.39,False
CARD_PAYMENT,Current,2025-02-06 18:05:08,McDonald's,-1690.0,61722.39,False
TRANSFER,Current,2025-02-09 16:58:05,To LEVENTE NANDOR POLGARI,-41000.0,20435.39,False
TOPUP,Current,2025-02-10 11:58:34,Top-Up by *7109,308846.0,329281.39,False
CARD_PAYMENT,Current,2025-02-10 12:00:06,Union Vienna Insurance Group,-27929.0,301352.39,False
TRANSFER,Current,2025-02-11 10:25:45,To HUF Temp,-250000.0,51352.39,False
TRANSFER,Current,2025-02-11 10:26:00,To HUF Temp,-20000.0,31352.39,False
CARD_PAYMENT,Current,2025-02-10 16:24:16,Wok n’ Go,-3800.0,27552.39,False
CARD_PAYMENT,Current,2025-02-11 07:55:15,Civis Cafe Canteen,-450.0,27102.39,False
CARD_PAYMENT,Current,2025-02-10 10:49:44,Viger Katalin E.v.,-1200.0,25902.39,False
CARD_PAYMENT,Current,2025-02-11 11:48:25,Civis Cafe Canteen,-3118.0,22784.39,False
TOPUP,Current,2025-02-11 19:40:52,Top-Up by *7109,9462.0,32246.39,False
TRANSFER,Current,2025-02-11 19:41:29,Transfer to Revolut user,-9400.0,22846.39,False
CARD_PAYMENT,Current,2025-02-11 21:14:57,Tippmixpro,-1500.0,21346.39,False
CARD_PAYMENT,Current,2025-02-11 17:13:01,Coop,-1106.0,20240.39,False
TRANSFER,Current,2025-02-12 15:32:54,Transfer to Revolut user,-5000.0,15240.39,False
TOPUP,Current,2025-02-12 15:33:06,Top-Up by *7109,5000.0,20240.39,False
TRANSFER,Current,2025-02-12 20:25:12,To HUF,35000.0,55240.39,False
TRANSFER,Current,2025-02-12 20:26:08,To Zéti Polgári,-28000.0,27044.39,False
TOPUP,Current,2025-02-12 23:34:34,Top-Up by *4479,12800.0,39844.39,False
CARD_PAYMENT,Current,2025-02-12 12:34:03,Nemzeti Dohánybolt,-2379.0,37465.39,False
CARD_PAYMENT,Current,2025-02-12 21:29:28,McDonald's,-2110.0,35355.39,False
TRANSFER,Current,2025-02-13 16:32:31,To Zéti Polgári,-6000.0,29313.39,False
TRANSFER,Current,2025-02-14 09:20:45,To HUF,10000.0,39313.39,False
CARD_PAYMENT,Current,2025-02-13 14:10:31,Simple,-7289.0,32024.39,False
CARD_PAYMENT,Current,2025-02-14 07:54:34,Civis Cafe Canteen,-744.0,31280.39,False
CARD_PAYMENT,Current,2025-02-14 11:47:39,Civis Cafe Canteen,-1690.0,29590.39,False
TRANSFER,Current,2025-02-14 18:28:08,To HUF,10000.0,39590.39,False
CARD_PAYMENT,Current,2025-02-14 07:55:53,Cocacolahbcmagyaror,-500.0,39090.39,False
CARD_PAYMENT,Current,2025-02-14 17:02:11,Vir Var Dekor,-6000.0,33090.39,False
TRANSFER,Current,2025-02-15 18:15:48,Transfer from Revolut user,100000.0,133090.39,False
TRANSFER,Current,2025-02-15 18:17:24,To Anett Moldován,-99000.0,33397.39,False
TRANSFER,Current,2025-02-16 00:32:50,To HUF,15000.0,48397.39,False
CARD_PAYMENT,Current,2025-02-14 09:18:22,Liliput Játékvilág,-19289.0,29108.39,False
CARD_PAYMENT,Current,2025-02-15 22:47:48,Spontán Café & Lounge,-1200.0,27908.39,False
CARD_PAYMENT,Current,2025-02-15 21:33:37,Péterfia Rock Söröző,-690.0,27218.39,False
TRANSFER,Current,2025-02-16 11:52:03,To HUF,35000.0,62218.39,False
CARD_PAYMENT,Current,2025-02-15 09:18:09,PENNY,-5151.0,57067.39,False
CARD_PAYMENT,Current,2025-02-15 15:43:35,Nemzeti Dohánybolt,-1700.0,55367.39,False
CARD_PAYMENT,Current,2025-02-16 00:43:05,MAXILine Töltőállomás,-10068.0,45299.39,False
TOPUP,Current,2025-02-17 17:14:15,Top-Up by *7109,4000.0,49299.39,False
CARD_PAYMENT,Current,2025-02-17 16:37:55,Lidl,-5069.0,44230.39,False
CARD_PAYMENT,Current,2025-02-18 21:57:13,Spotify,-1090.0,43140.39,False
CARD_PAYMENT,Current,2025-02-18 15:45:40,HELLA AUTOTECHNIK NOVA s.r.o.,-430.0,42710.39,False
CARD_PAYMENT,Current,2025-02-18 09:35:21,Debreceni Egyetem,-470.0,42240.39,False
CARD_PAYMENT,Current,2025-02-18 11:37:31,"Diagnostic Sport, Lifestyle and Therapy Center",-13000.0,29240.39,False
CARD_PAYMENT,Current,2025-02-20 07:49:24,Cocacolahbcmagyaror,-500.0,28740.39,False
TRANSFER,Current,2025-02-21 19:52:35,Transfer to Revolut user,-3000.0,25740.39,False
TRANSFER,Current,2025-02-21 19:53:48,Transfer from Revolut user,3000.0,28740.39,False
CARD_PAYMENT,Current,2025-02-21 13:31:11,Viger Katalin E.v.,-1420.0,27320.39,False
CARD_PAYMENT,Current,2025-02-21 19:43:47,Apolló Mozi,-3300.0,24020.39,False
TRANSFER,Current,2025-02-22 15:36:57,To Lilla Salanki,-4500.0,19488.89,False
TRANSFER,Current,2025-02-23 15:11:56,To HUF,50000.0,69488.89,False
TRANSFER,Current,2025-02-23 15:16:11,To HUF Temp,-30000.0,39488.89,False
TRANSFER,Current,2025-02-24 09:28:48,Transfer from Revolut user,2063.34,41552.23,False
CARD_PAYMENT,Current,2025-02-23 15:14:00,MAXILine Töltőállomás,-20819.0,20733.23,False
CARD_PAYMENT,Current,2025-02-24 08:57:19,Apple,-6190.0,14543.23,False
CARD_PAYMENT,Current,2025-02-24 17:25:48,HELLA AUTOTECHNIK NOVA s.r.o.,-430.0,14113.23,False
CARD_PAYMENT,Current,2025-02-24 15:47:56,Simple,-896.0,13217.23,False
CARD_PAYMENT,Current,2025-02-25 12:27:37,Twitch,-2018.22,11199.01,False
CARD_PAYMENT,Current,2025-02-25 12:46:56,Coop,-1997.0,9202.01,False
CARD_PAYMENT,Current,2025-02-24 23:11:57,De Agra'r Kapu,-2200.0,7002.01,False
CARD_PAYMENT,Current,2025-02-25 17:51:18,Simple,-209.0,6793.01,False
TRANSFER,Current,2025-02-26 20:03:06,To HUF,10000.0,16793.01,False
TRANSFER,Current,2025-02-26 20:08:09,Transfer from Revolut user,8000.0,24793.01,False
TRANSFER,Current,2025-02-26 22:05:30,Transfer from Revolut user,2000.0,26793.01,False
CARD_PAYMENT,Current,2025-02-26 20:08:10,KFC,-9700.0,17093.01,False
CARD_PAYMENT,Current,2025-02-27 12:20:38,Civis Cafe Canteen,-2014.0,15079.01,False
TRANSFER,Current,2025-02-28 09:05:40,Transfer to Revolut user,-2000.0,13079.01,False
CARD_PAYMENT,Current,2025-02-27 08:01:04,Cocacolahbcmagyaror,-500.0,12579.01,False
CARD_PAYMENT,Current,2025-02-27 14:17:32,Cocacolahbcmagyaror,-500.0,12079.01,False
TRANSFER,Current,2025-02-28 12:09:35,To HUF,50000.0,62079.01,False
TRANSFER,Current,2025-02-28 12:40:34,HUF → Revolut X,-20167.49,41911.52,False
CARD_PAYMENT,Current,2025-02-28 12:09:43,Coinbase,-20165.72,21745.8,False
TRANSFER,Current,2025-02-28 20:06:46,Transfer from Revolut user,2000.0,23745.8,False
TRANSFER,Current,2025-02-28 20:07:37,Transfer to Revolut user,-2000.0,21745.8,False
CARD_PAYMENT,Current,2025-02-28 20:07:18,KFC,-5970.0,15775.8,False
CARD_PAYMENT,Current,2025-03-02 12:47:41,Nemzeti Dohánybolt,-1800.0,13975.8,False
TRANSFER,Current,2025-03-03 18:22:01,Transfer to Revolut user,-0.4,13975.4,False
TRANSFER,Current,2025-03-03 18:22:10,Transfer to Revolut user,-0.4,13975.0,False
EXCHANGE,Current,2025-03-03 18:27:14,Exchange to HUF,19.84,13994.84,False
TRANSFER,Current,2025-03-03 19:02:49,To HUF,15000.0,28994.84,False
TRANSFER,Current,2025-03-03 19:38:11,To LEVENTE NANDOR POLGARI,-900.0,28088.54,False
CARD_PAYMENT,Current,2025-03-03 19:03:10,Fizz,-14780.0,13308.54,False
CARD_PAYMENT,Current,2025-03-03 15:46:42,Simple,-1002.0,12306.54,False
TRANSFER,Current,2025-03-04 15:41:12,Transfer to Revolut user,-6000.0,6306.54,False
TRANSFER,Current,2025-03-04 16:48:48,To HUF,5000.0,11306.54,False
CARD_PAYMENT,Current,2025-03-04 20:29:32,GLS,-6480.0,4826.54,False
CARD_PAYMENT,Current,2025-03-04 13:10:04,Simple,-242.0,4584.54,False
TOPUP,Current,2025-03-06 10:56:22,Top-Up by *7109,128816.0,133400.54,False
TRANSFER,Current,2025-03-06 13:16:23,Transfer from Revolut user,127.64,133528.18,False
EXCHANGE,Current,2025-03-06 13:16:55,Exchange to HUF,50493.91,184022.09,False
TRANSFER,Current,2025-03-06 13:17:14,Transfer to Revolut user,-50500.0,133522.09,False
TRANSFER,Current,2025-03-06 14:22:39,Transfer to Revolut user,-5000.0,128522.09,False
TRANSFER,Current,2025-03-06 14:24:19,Transfer from Revolut user,5000.0,133522.09,False
CARD_PAYMENT,Current,2025-03-06 11:00:18,Trading 212,-20154.39,113367.7,False
CARD_PAYMENT,Current,2025-03-06 10:59:24,Trading 212,-20161.69,93206.01,False
TRANSFER,Current,2025-03-06 18:37:27,Transfer from Revolut user,3700.0,96906.01,False
TOPUP,Current,2025-03-06 18:37:49,Top-Up by *7109,11300.0,108206.01,False
TRANSFER,Current,2025-03-07 10:38:27,To LEVENTE NANDOR POLGARI,-1000.0,107199.01,False
CARD_PAYMENT,Current,2025-03-07 17:26:40,Nemzeti Dohánybolt,-1800.0,105399.01,False
TRANSFER,Current,2025-03-08 14:10:40,Transfer from Revolut user,7000.0,112399.01,False
TRANSFER,Current,2025-03-08 18:02:21,Transfer from Revolut user,50000.0,162399.01,False
CARD_PAYMENT,Current,2025-03-07 21:32:27,Burger King,-5270.0,157129.01,False
TRANSFER,Current,2025-03-09 11:01:03,To HUF Temp,-50000.0,107129.01,False
CARD_PAYMENT,Current,2025-03-08 10:20:51,Uveges Nikolett,-16499.0,90630.01,False
TRANSFER,Current,2025-03-09 11:46:31,To Anett Moldován,-20000.0,70490.01,False
TRANSFER,Current,2025-03-09 11:46:43,To Zéti Polgári,-20000.0,50350.01,False
TRANSFER,Current,2025-03-09 11:46:56,To HUF,50000.0,100350.01,False
CARD_PAYMENT,Current,2025-03-08 10:11:37,Simple,-244.0,100106.01,False
TRANSFER,Current,2025-03-09 15:53:25,Transfer from Revolut user,2000.0,102106.01,False
CARD_PAYMENT,Current,2025-03-09 10:42:35,Viger Katalin E.v.,-1430.0,100676.01,False
CARD_PAYMENT,Current,2025-03-09 15:10:31,Nagy Beki Pekseg,-400.0,100276.01,False
TOPUP,Current,2025-03-10 12:04:49,Top-Up by *7109,185000.0,285276.01,False
TRANSFER,Current,2025-03-10 12:06:21,To HUF Temp,-230000.0,55276.01,False
TRANSFER,Current,2025-03-10 15:48:11,To HUF,330000.0,385276.01,False
TRANSFER,Current,2025-03-10 15:48:34,To Savings Account,-300000.0,85276.01,False
TRANSFER,Current,2025-03-10 20:16:09,To Mark Fodor,-2000.0,83262.01,False
CARD_PAYMENT,Current,2025-03-09 22:18:45,Árukereső,-15490.0,67772.01,False
CARD_PAYMENT,Current,2025-03-10 15:04:16,barion,-11380.0,56392.01,False
CARD_PAYMENT,Current,2025-03-11 17:52:26,Simple,-209.0,56183.01,False
CARD_PAYMENT,Current,2025-03-13 17:07:43,Nemzeti Dohánybolt,-1800.0,54383.01,False
TRANSFER,Current,2025-03-14 09:59:01,Transfer to Revolut user,-15000.0,39383.01,False
CARD_PAYMENT,Current,2025-03-13 21:39:31,eMAG,-3348.0,36035.01,False
TRANSFER,Current,2025-03-14 15:28:15,Transfer from Revolut user,50000.0,86035.01,False
TRANSFER,Current,2025-03-14 15:28:37,To Anett Moldován,-49500.0,36188.51,False
TRANSFER,Current,2025-03-15 00:22:09,Transfer from Revolut user,1500.0,37688.51,False
TRANSFER,Current,2025-03-15 00:24:55,From Savings Account,10000.0,47688.51,False
TRANSFER,Current,2025-03-15 00:26:08,Transfer from Revolut user,1500.0,49188.51,False
TOPUP,Current,2025-03-15 01:10:28,Top-Up by *7109,26000.0,75188.51,False
TRANSFER,Current,2025-03-15 01:13:23,To Savings Account,-10000.0,65188.51,False
CARD_PAYMENT,Current,2025-03-14 22:55:44,Wolt,-5096.0,60092.51,False
CARD_PAYMENT,Current,2025-03-14 21:12:09,StatiON Bowling Debrecen,-4422.0,55670.51,False
CARD_PAYMENT,Current,2025-03-14 21:52:29,Nemzeti Dohánybolt,-2400.0,53270.51,False
CARD_PAYMENT,Current,2025-03-14 21:49:17,Nemzeti Dohánybolt,-3000.0,50270.51,False
TRANSFER,Current,2025-03-15 14:50:00,From Savings Account,30000.0,80270.51,False
TRANSFER,Current,2025-03-15 14:58:05,Transfer from Revolut user,2500.0,82770.51,False
CARD_PAYMENT,Current,2025-03-15 14:57:47,KFC,-4690.0,78080.51,False
CARD_PAYMENT,Current,2025-03-15 21:37:30,MAXILine Töltőállomás,-19223.0,58857.51,False
CARD_PAYMENT,Current,2025-03-15 00:25:02,StatiON Bowling Debrecen,-29600.0,29257.51,False
TRANSFER,Current,2025-03-17 13:06:22,From Savings Account,70000.0,99257.51,False
CARD_PAYMENT,Current,2025-03-17 10:18:31,Charlotte Tilbury,-16887.56,82369.95,False
TRANSFER,Current,2025-03-18 12:59:57,Transfer from Revolut user,1000.0,83369.95,False
CARD_PAYMENT,Current,2025-03-17 15:51:22,Simple,-816.0,82553.95,False
CARD_PAYMENT,Current,2025-03-18 21:57:19,Spotify,-1090.0,81463.95,False
CARD_PAYMENT,Current,2025-03-18 12:00:56,Simple,-595.0,80868.95,False
CARD_PAYMENT,Current,2025-03-18 17:52:42,Simple,-209.0,80659.95,False
TRANSFER,Current,2025-03-20 17:49:58,Transfer from Revolut user,54.91,80714.86,False
EXCHANGE,Current,2025-03-20 17:50:40,Exchange to HUF,21681.15,102396.01,False
CARD_PAYMENT,Current,2025-03-19 11:48:37,Nemzeti Dohánybolt,-1900.0,100496.01,False
CARD_PAYMENT,Current,2025-03-20 17:56:40,Tippmixpro,-2000.0,98496.01,False
CARD_PAYMENT,Current,2025-03-20 17:12:12,Tippmixpro,-25000.0,73496.01,False
TRANSFER,Current,2025-03-21 07:51:06,To Anett Moldován,-40000.0,33216.01,False
TRANSFER,Current,2025-03-21 22:18:05,Transfer from Revolut user,4000.0,37216.01,False
TOPUP,Current,2025-03-21 22:47:18,Top-Up by *4479,10000.0,47216.01,False
CARD_PAYMENT,Current,2025-03-21 13:11:11,Allegro,-6010.0,41206.01,False
CARD_PAYMENT,Current,2025-03-21 13:14:12,Schenopol,-3705.0,37501.01,False
EXCHANGE,Current,2025-03-22 23:47:48,Exchange to HUF,102450.72,138927.22,False
TRANSFER,Current,2025-03-22 23:49:32,Transfer to Revolut user,-49000.0,89927.22,False
CARD_PAYMENT,Current,2025-03-21 22:18:00,McDonald's,-5690.0,84237.22,False
CARD_PAYMENT,Current,2025-03-22 16:54:31,Nemzeti Dohánybolt,-11728.0,72509.22,False
CARD_PAYMENT,Current,2025-03-22 13:52:22,Nagy Beki Pekseg,-1330.0,71179.22,False
CARD_PAYMENT,Current,2025-03-22 10:38:33,"Diagnostic Sport, Lifestyle and Therapy Center",-13000.0,58179.22,False
CARD_PAYMENT,Current,2025-03-23 17:52:51,Tippmixpro,-4000.0,54179.22,False
TRANSFER,Current,2025-03-24 12:28:42,Transfer from Revolut user,4000.0,58179.22,False
CARD_PAYMENT,Current,2025-03-24 18:02:30,The Box Donut Debrecen,-2580.0,55599.22,False
CARD_PAYMENT,Current,2025-03-24 07:57:34,Apple,-6190.0,49409.22,False
TRANSFER,Current,2025-03-25 13:39:08,Transfer to Revolut user,-2300.0,47109.22,False
TRANSFER,Current,2025-03-25 16:52:01,Transfer to Revolut user,-1000.0,46109.22,False
TRANSFER,Current,2025-03-25 16:52:34,Transfer from Revolut user,1000.0,47109.22,False
CARD_PAYMENT,Current,2025-03-25 17:55:34,Both-Dega Büfe,-1220.0,45889.22,False
CARD_PAYMENT,Current,2025-03-25 07:49:40,HELLA AUTOTECHNIK NOVA s.r.o.,-430.0,45459.22,False
CARD_PAYMENT,Current,2025-03-25 12:27:39,Twitch,-2001.16,43458.06,False
CARD_PAYMENT,Current,2025-03-26 07:56:43,Civis Cafe Canteen,-2631.0,40827.06,False
TOPUP,Current,2025-03-27 11:50:47,Top-Up by *7109,6560.0,47387.06,False
CARD_PAYMENT,Current,2025-03-26 07:58:01,1605021531 Gfa It,-500.0,46887.06,False
ATM,Current,2025-03-29 16:10:40,"Cash at Sarand, Nagy U. 50.",-13000.0,33887.06,False
TRANSFER,Current,2025-03-31 14:14:39,Transfer from Revolut user,10000.0,43887.06,False
TRANSFER,Current,2025-03-31 14:15:04,Transfer to Revolut user,-10000.0,33887.06,False
CARD_PAYMENT,Current,2025-03-30 19:43:09,Apollo Cinema,-3520.0,30367.06,False
CARD_PAYMENT,Current,2025-03-31 19:33:38,Nemzeti Dohánybolt,-1800.0,28567.06,False
TRANSFER,Current,2025-04-02 10:25:26,From Savings Account,20000.0,48567.06,False
CARD_PAYMENT,Current,2025-04-01 11:38:43,KFC,-2490.0,46077.06,False
CARD_PAYMENT,Current,2025-04-01 11:35:03,Simple,-577.0,45500.06,False
CARD_PAYMENT,Current,2025-04-02 10:33:44,Techsend,-22480.0,23020.06,False
CARD_PAYMENT,Current,2025-04-04 07:44:34,Civis Cafe Canteen,-350.0,22670.06,False
CARD_PAYMENT,Current,2025-04-04 11:55:47,Civis Cafe Canteen,-1827.0,20843.06,False
CARD_PAYMENT,Current,2025-04-04 07:45:43,1605021531 Gfa It,-500.0,20343.06,False
CARD_PAYMENT,Current,2025-04-05 16:42:41,Crunchyroll,-300.0,,False
CARD_PAYMENT,Current,2025-04-03 23:39:16,McDonald's,-3250.0,17093.06,False
CARD_PAYMENT,Current,2025-04-05 22:02:49,Megálló Pizzéria és Ételbár,-11270.0,5823.06,False
TRANSFER,Current,2025-04-06 19:20:23,From Savings Account,20000.0,25823.06,False
CARD_PAYMENT,Current,2025-04-06 20:03:34,KFC,-3980.0,21843.06,False
CARD_PAYMENT,Current,2025-04-06 20:35:42,McDonald's,-820.0,21023.06,False
TRANSFER,Current,2025-04-07 23:36:29,Transfer from Revolut user,110000.0,131023.06,False
TRANSFER,Current,2025-04-07 23:37:03,To Anett Moldován,-109250.0,21008.31,False
TOPUP,Current,2025-04-08 13:48:50,Top-Up by *7109,175000.0,196008.31,False
TRANSFER,Current,2025-04-08 13:50:35,To Savings Account,-40000.0,156008.31,False
TRANSFER,Current,2025-04-08 15:06:06,To Savings Account,-100000.0,56008.31,False
CARD_PAYMENT,Current,2025-04-08 07:40:35,Civis Cafe Canteen,-1319.0,54689.31,False
CARD_PAYMENT,Current,2025-04-08 12:32:00,Civis Cafe Canteen,-3916.0,50773.31,False
TRANSFER,Current,2025-04-08 17:06:35,Transfer to Revolut user,-3000.0,47773.31,False
TRANSFER,Current,2025-04-09 12:12:05,Transfer from Revolut user,1480.0,49253.31,False
TRANSFER,Current,2025-04-09 12:12:00,Transfer from Revolut user,820.0,50073.31,False
CARD_PAYMENT,Current,2025-04-08 07:42:41,1605021531 Gfa It,-500.0,49573.31,False
TOPUP,Current,2025-04-10 10:49:25,Top-Up by *7109,237000.0,286573.31,False
TRANSFER,Current,2025-04-10 10:50:33,To HUF Holidays,-150000.0,136573.31,False
TRANSFER,Current,2025-04-10 10:51:40,To HUF Holidays,-50000.0,86573.31,False
TRANSFER,Current,2025-04-10 10:52:05,To HUF,60000.0,146573.31,False
TRANSFER,Current,2025-04-10 10:53:57,Transfer to Revolut user,-60000.0,86573.31,False
CARD_PAYMENT,Current,2025-04-09 11:37:50,Coop,-873.0,85700.31,False
CARD_PAYMENT,Current,2025-04-09 12:11:27,Simple,-793.0,84907.31,False
CARD_PAYMENT,Current,2025-04-09 10:25:39,Benu,-1849.0,83058.31,False
CARD_PAYMENT,Current,2025-04-09 10:34:25,MAXILine Töltőállomás,-22585.0,60473.31,False
CARD_PAYMENT,Current,2025-04-10 18:32:32,Popbeni Kft.,-420.0,60053.31,False
CARD_PAYMENT,Current,2025-04-10 08:37:58,Coop,-1746.0,58307.31,False
CARD_PAYMENT,Current,2025-04-10 15:56:45,Nemzeti Dohánybolt,-1700.0,56607.31,False
CARD_PAYMENT,Current,2025-04-11 07:02:29,Nemzeti Dohánybolt,-1018.0,55589.31,False
TOPUP,Current,2025-04-12 14:06:48,Top-Up by *7109,4000.0,59589.31,False
TRANSFER,Current,2025-04-12 14:08:13,Transfer from Revolut user,4149.6,63738.91,False
TRANSFER,Current,2025-04-12 14:08:16,Transfer from Revolut user,3838.0,67576.91,False
CARD_PAYMENT,Current,2025-04-12 13:57:46,Wolt,-4149.6,63427.31,False
CARD_PAYMENT,Current,2025-04-12 13:56:56,Wolt,-3838.0,59589.31,False
CARD_PAYMENT,Current,2025-04-12 22:32:36,Sheldon's,-2499.0,57090.31,False
CARD_PAYMENT,Current,2025-04-12 13:12:07,Reál,-2860.0,54230.31,False
CARD_PAYMENT,Current,2025-04-12 13:15:04,Nemzeti Dohánybolt,-2125.0,52105.31,False
CARD_PAYMENT,Current,2025-04-12 16:43:16,Crunchyroll,-2450.0,49655.31,False
CARD_PAYMENT,Current,2025-04-14 17:05:43,Reál,-1227.0,48428.31,False
CARD_PAYMENT,Current,2025-04-15 13:37:44,Coop,-1346.0,47082.31,False
CARD_PAYMENT,Current,2025-04-15 17:54:40,Simple,-209.0,46873.31,False
CARD_PAYMENT,Current,2025-04-16 20:18:07,Tesco,-3569.0,43304.31,False
CARD_PAYMENT,Current,2025-04-16 11:32:56,Nemzeti Dohánybolt,-1700.0,41604.31,False
CARD_PAYMENT,Current,2025-04-18 22:57:22,Spotify,-1090.0,40514.31,False
CARD_PAYMENT,Current,2025-04-19 11:33:14,Nemzeti Dohánybolt,-4163.0,36351.31,False
TRANSFER,Savings,2025-01-05 15:16:16,To HUF Dentist,50000.0,50000.0,False
TRANSFER,Savings,2025-01-20 12:58:03,To HUF Temp,450000.0,500000.0,False
TRANSFER,Savings,2025-01-23 14:09:04,To HUF,-15000.0,485000.0,False
TRANSFER,Savings,2025-01-26 15:49:28,To HUF,-450000.0,35000.0,False
TRANSFER,Savings,2025-02-11 10:25:45,To HUF Temp,250000.0,285000.0,False
TRANSFER,Savings,2025-02-11 10:26:00,To HUF Temp,20000.0,305000.0,False
TRANSFER,Savings,2025-02-12 20:25:12,To HUF,-35000.0,270000.0,False
TRANSFER,Savings,2025-02-14 09:20:45,To HUF,-10000.0,260000.0,False
TRANSFER,Savings,2025-02-14 18:28:08,To HUF,-10000.0,250000.0,False
TRANSFER,Savings,2025-02-14 18:28:22,Closing transaction,0.0,250000.0,False
TRANSFER,Savings,2025-02-16 00:32:50,To HUF,-15000.0,235000.0,False
TRANSFER,Savings,2025-02-16 11:52:03,To HUF,-35000.0,200000.0,False
TRANSFER,Savings,2025-02-23 15:11:56,To HUF,-50000.0,150000.0,False
TRANSFER,Savings,2025-02-23 15:16:11,To HUF Temp,30000.0,180000.0,False
TRANSFER,Savings,2025-02-26 20:03:06,To HUF,-10000.0,170000.0,False
TRANSFER,Savings,2025-02-28 12:09:35,To HUF,-50000.0,120000.0,False
TRANSFER,Savings,2025-03-03 19:02:49,To HUF,-15000.0,105000.0,False
TRANSFER,Savings,2025-03-04 16:48:48,To HUF,-5000.0,100000.0,False
TRANSFER,Savings,2025-03-09 11:01:03,To HUF Temp,50000.0,150000.0,False
TRANSFER,Savings,2025-03-09 11:46:56,To HUF,-50000.0,100000.0,False
TRANSFER,Savings,2025-03-10 12:06:21,To HUF Temp,230000.0,330000.0,False
TRANSFER,Savings,2025-03-10 15:48:11,To HUF,-330000.0,0.0,False
TRANSFER,Savings,2025-03-10 15:48:23,Closing transaction,0.0,0.0,False
TRANSFER,Savings,2025-04-10 10:50:33,To HUF Holidays,150000.0,150000.0,False
TRANSFER,Savings,2025-04-10 10:51:40,To HUF Holidays,50000.0,200000.0,False
TRANSFER,Savings,2025-04-10 10:52:05,To HUF,-60000.0,140000.0,False
TRANSFER,Deposit,2025-03-10 15:48:34,To Savings Account,300000.0,300000.0,False
TRANSFER,Deposit,2025-03-15 00:24:55,From Savings Account,-10000.0,290034.93,False
TRANSFER,Deposit,2025-03-15 01:13:23,To Savings Account,10000.0,300034.93,False
TRANSFER,Deposit,2025-03-15 14:50:00,From Savings Account,-30000.0,270043.67,False
TRANSFER,Deposit,2025-03-17 13:06:22,From Savings Account,-70000.0,200059.38,False
TRANSFER,Deposit,2025-04-02 10:25:26,From Savings Account,-20000.0,180152.55,False
TRANSFER,Deposit,2025-04-06 19:20:23,From Savings Account,-20000.0,160173.51,False
TRANSFER,Deposit,2025-04-08 13:50:35,To Savings Account,40000.0,200182.84,False
TRANSFER,Deposit,2025-04-08 15:06:06,To Savings Account,100000.0,300182.84,False
FEE,Current,2025-01-01 02:06:13,Premium plan fee,-3000.0,100213.04,False
TRANSFER,Current,2025-01-01 17:22:08,Transfer to Revolut user,-100000.0,213.04,False
TRANSFER,Current,2025-01-01 17:24:44,Transfer from Revolut user,995000.0,995213.04,False
EXCHANGE,Current,2025-01-01 17:26:51,Exchange to EUR,-995000.0,213.04,False
TRANSFER,Current,2025-01-01 21:07:33,Transfer from Revolut user,140000.0,140213.04,False
TRANSFER,Current,2025-01-02 09:10:25,To Anett Moldován,-139000.0,240.04,False
TOPUP,Current,2025-01-02 17:47:49,Top-Up by *7109,100000.0,100240.04,False
TRANSFER,Current,2025-01-03 00:44:04,To LEVENTE NANDOR POLGARI,-3000.0,97219.04,False
TOPUP,Current,2025-01-03 00:44:18,Top-Up by *7109,5300.0,102519.04,False
CARD_PAYMENT,Current,2025-01-02 18:16:56,KFC,-2390.0,100129.04,False
TRANSFER,Current,2025-01-04 13:51:19,Transfer to Revolut user,-3700.0,96429.04,False
CARD_PAYMENT,Current,2025-01-03 11:19:35,Magyar Posta,-30970.0,65459.04,False
CARD_PAYMENT,Current,2025-01-03 20:07:39,Bartók Csemege,-2239.0,63220.04,False
CARD_REFUND,Current,2025-01-04 01:00:00,Delfinbúvár,2870.0,66090.04,False
TRANSFER,Current,2025-01-05 14:34:44,Transfer from Revolut user,50000.0,116090.04,False
TRANSFER,Current,2025-01-05 15:16:16,To HUF Dentist,-50000.0,66090.04,False
TOPUP,Current,2025-01-08 12:08:57,Top-Up by *7109,20000.0,86090.04,False
CARD_PAYMENT,Current,2025-01-07 16:42:26,MAXILine Töltőállomás,-10002.0,76088.04,False
CARD_PAYMENT,Current,2025-01-08 17:04:47,Simple,-613.0,75475.04,False
CARD_PAYMENT,Current,2025-01-08 17:53:02,Magyar Posta,-7170.0,68305.04,False
TOPUP,Current,2025-01-10 11:48:42,Top-Up by *7109,241357.0,309662.04,False
TRANSFER,Current,2025-01-10 11:51:41,Transfer from Revolut user,29971.5,339633.54,False
TRANSFER,Current,2025-01-10 23:04:20,Transfer to Revolut user,-60000.0,279633.54,False
TRANSFER,Current,2025-01-10 23:05:18,Transfer from Revolut user,60000.0,339633.54,False
EXCHANGE,Current,2025-01-10 23:06:31,Exchange to EUR,-60000.0,279633.54,False
TRANSFER,Current,2025-01-10 23:13:43,To LEVENTE NANDOR POLGARI,-30000.0,249423.54,False
TOPUP,Current,2025-01-10 23:16:27,Top-Up by *7109,10660.0,260083.54,False
CARD_PAYMENT,Current,2025-01-10 11:39:29,Xiaomi Official,-14490.0,245593.54,False
CARD_PAYMENT,Current,2025-01-10 11:50:28,Airbnb,-59943.0,185650.54,False
CARD_PAYMENT,Current,2025-01-10 12:45:43,ANRO épületdíszétés,-4390.0,181260.54,False
TRANSFER,Current,2025-01-11 17:15:43,Transfer from Revolut user,20000.0,201260.54,False
TOPUP,Current,2025-01-12 18:24:15,Top-Up by *7109,6000.0,207260.54,False
TRANSFER,Current,2025-01-12 18:24:33,Transfer to Revolut user,-6000.0,201260.54,False
TOPUP,Current,2025-01-12 23:45:51,Top-Up by *7109,82280.0,283540.54,False
CARD_PAYMENT,Current,2025-01-12 23:44:21,Alza,-82280.0,201260.54,False
CARD_PAYMENT,Current,2025-01-13 14:23:15,Trading 212,-41686.99,159573.55,False
TOPUP,Current,2025-01-14 15:11:32,Top-Up by *7109,70000.0,229573.55,False
CARD_PAYMENT,Current,2025-01-14 15:32:06,Vir Var Dekor,-3000.0,226573.55,False
CARD_PAYMENT,Current,2025-01-14 17:09:36,Nemzeti Dohánybolt,-1700.0,224873.55,False
CARD_PAYMENT,Current,2025-01-14 12:14:41,Nemzeti Mobilfizetési,-480.0,224393.55,False
CARD_PAYMENT,Current,2025-01-14 13:35:31,Coop,-857.0,223536.55,False
CARD_PAYMENT,Current,2025-01-14 15:15:29,Nemzeti Dohánybolt,-949.0,222587.55,False
TRANSFER,Current,2025-01-15 22:57:46,Transfer from Revolut user,3500.0,226087.55,False
CARD_PAYMENT,Current,2025-01-15 19:56:37,Wolt,-6739.0,219348.55,False
TRANSFER,Current,2025-01-16 17:35:53,To Zéti Polgári,-10000.0,209278.55,False
CARD_PAYMENT,Current,2025-01-16 09:36:44,Civis Cafe Canteen,-115.0,209163.55,False
CARD_PAYMENT,Current,2025-01-17 20:58:14,Wolt,-3729.0,205434.55,False
CARD_PAYMENT,Current,2025-01-17 16:28:00,Nemzeti Dohánybolt,-1800.0,203634.55,False
CARD_PAYMENT,Current,2025-01-17 16:36:30,CBA,-2346.0,201288.55,False
CARD_PAYMENT,Current,2025-01-18 21:57:17,Spotify,-1090.0,200198.55,False
TRANSFER,Current,2025-01-19 20:28:12,Transfer to Revolut user,-2800.0,197398.55,False
TRANSFER,Current,2025-01-19 20:28:34,Transfer to Revolut user,-25000.0,172398.55,False
TRANSFER,Current,2025-01-19 20:28:52,Transfer from Revolut user,25000.0,197398.55,False
TRANSFER,Current,2025-01-19 20:28:59,Transfer from Revolut user,2800.0,200198.55,False
TOPUP,Current,2025-01-20 12:55:43,Top-Up by *7109,450000.0,650198.55,False
TRANSFER,Current,2025-01-20 12:58:03,To HUF Temp,-450000.0,200198.55,False
CARD_PAYMENT,Current,2025-01-19 10:38:57,ALDI,-564.0,199634.55,False
CARD_PAYMENT,Current,2025-01-19 16:07:56,Nemzeti Dohánybolt,-2400.0,197234.55,False
CARD_PAYMENT,Current,2025-01-21 18:33:35,Hamburger Bár,-580.0,196654.55,False
TRANSFER,Current,2025-01-23 11:11:48,Transfer to Revolut user,-15000.0,181654.55,False
TRANSFER,Current,2025-01-23 14:04:54,Transfer from Revolut user,2500.0,184154.55,False
TRANSFER,Current,2025-01-23 14:09:04,To HUF,15000.0,199154.55,False
TRANSFER,Current,2025-01-23 14:22:13,Transfer from Revolut user,2000.0,201154.55,False
CARD_PAYMENT,Current,2025-01-23 14:11:39,Wolt,-5366.4,195788.15,False
TRANSFER,Current,2025-01-24 17:28:59,Transfer to Revolut user,-60000.0,135788.15,False
TRANSFER,Current,2025-01-24 18:27:59,Transfer to Revolut user,-5000.0,130788.15,False
TOPUP,Current,2025-01-24 18:51:06,Top-Up by *7109,65000.0,195788.15,False
CARD_PAYMENT,Current,2025-01-24 08:58:23,Apple,-6190.0,189598.15,False
CARD_PAYMENT,Current,2025-01-24 17:31:18,Nemzeti Mobilfizetési,-560.0,189038.15,False
CARD_PAYMENT,Current,2025-01-24 18:51:55,ALDI,-3861.0,185177.15,False
CARD_PAYMENT,Current,2025-01-24 18:54:37,Nemzeti Dohánybolt,-1800.0,183377.15,False
TRANSFER,Current,2025-01-25 23:13:21,To Zéti Polgári,-77500.0,105334.65,False
CARD_PAYMENT,Current,2025-01-25 12:27:35,Twitch,-2044.41,103269.8,False
CARD_PAYMENT,Current,2025-01-25 12:47:51,Nemzeti Mobilfizetési,-480.0,102789.8,False
TRANSFER,Current,2025-01-26 15:49:28,To HUF,450000.0,552789.8,False
TRANSFER,Current,2025-01-26 15:50:06,To Anett Moldován,-547000.0,1960.8,False
CARD_PAYMENT,Current,2025-01-25 12:57:44,McDonald's,-1490.0,470.8,False
EXCHANGE,Current,2025-01-27 09:10:23,Exchange to HUF,81009.18,81479.98,False
TRANSFER,Current,2025-01-27 23:57:51,Transfer from Revolut user,140000.0,221479.98,False
TRANSFER,Current,2025-01-28 08:46:56,To Anett Moldován,-138500.0,82010.48,False
CARD_PAYMENT,Current,2025-01-27 18:40:18,McDonald's,-2260.0,79750.48,False
CARD_PAYMENT,Current,2025-01-28 15:12:28,Dallmayr,-260.0,79490.48,False
CARD_PAYMENT,Current,2025-01-28 13:33:50,Debreceni Egyetem,-530.0,78960.48,False
CARD_PAYMENT,Current,2025-01-29 17:54:11,Nemzeti Dohánybolt,-2179.0,76781.48,False
FEE,Current,2025-02-01 02:22:59,Premium plan fee,-3000.0,73781.48,False
CARD_PAYMENT,Current,2025-02-04 15:50:58,Amazon Prime,-1900.0,71881.48,False
CARD_PAYMENT,Current,2025-02-06 17:42:12,Nemzeti Dohánybolt,-1088.0,70793.48,False
CARD_PAYMENT,Current,2025-02-05 19:07:07,Steam,-5234.09,65559.39,False
CARD_PAYMENT,Current,2025-02-05 22:09:37,Nemzeti Dohánybolt,-2147.0,63412.39,False
CARD_PAYMENT,Current,2025-02-06 18:05:08,McDonald's,-1690.0,61722.39,False
TRANSFER,Current,2025-02-09 16:58:05,To LEVENTE NANDOR POLGARI,-41000.0,20435.39,False
TOPUP,Current,2025-02-10 11:58:34,Top-Up by *7109,308846.0,329281.39,False
CARD_PAYMENT,Current,2025-02-10 12:00:06,Union Vienna Insurance Group,-27929.0,301352.39,False
TRANSFER,Current,2025-02-11 10:25:45,To HUF Temp,-250000.0,51352.39,False
TRANSFER,Current,2025-02-11 10:26:00,To HUF Temp,-20000.0,31352.39,False
CARD_PAYMENT,Current,2025-02-10 16:24:16,Wok n’ Go,-3800.0,27552.39,False
CARD_PAYMENT,Current,2025-02-11 07:55:15,Civis Cafe Canteen,-450.0,27102.39,False
CARD_PAYMENT,Current,2025-02-10 10:49:44,Viger Katalin E.v.,-1200.0,25902.39,False
CARD_PAYMENT,Current,2025-02-11 11:48:25,Civis Cafe Canteen,-3118.0,22784.39,False
TOPUP,Current,2025-02-11 19:40:52,Top-Up by *7109,9462.0,32246.39,False
TRANSFER,Current,2025-02-11 19:41:29,Transfer to Revolut user,-9400.0,22846.39,False
CARD_PAYMENT,Current,2025-02-11 21:14:57,Tippmixpro,-1500.0,21346.39,False
CARD_PAYMENT,Current,2025-02-11 17:13:01,Coop,-1106.0,20240.39,False
TRANSFER,Current,2025-02-12 15:32:54,Transfer to Revolut user,-5000.0,15240.39,False
TOPUP,Current,2025-02-12 15:33:06,Top-Up by *7109,5000.0,20240.39,False
TRANSFER,Current,2025-02-12 20:25:12,To HUF,35000.0,55240.39,False
TRANSFER,Current,2025-02-12 20:26:08,To Zéti Polgári,-28000.0,27044.39,False
TOPUP,Current,2025-02-12 23:34:34,Top-Up by *4479,12800.0,39844.39,False
CARD_PAYMENT,Current,2025-02-12 12:34:03,Nemzeti Dohánybolt,-2379.0,37465.39,False
CARD_PAYMENT,Current,2025-02-12 21:29:28,McDonald's,-2110.0,35355.39,False
TRANSFER,Current,2025-02-13 16:32:31,To Zéti Polgári,-6000.0,29313.39,False
TRANSFER,Current,2025-02-14 09:20:45,To HUF,10000.0,39313.39,False
CARD_PAYMENT,Current,2025-02-13 14:10:31,Simple,-7289.0,32024.39,False
CARD_PAYMENT,Current,2025-02-14 07:54:34,Civis Cafe Canteen,-744.0,31280.39,False
CARD_PAYMENT,Current,2025-02-14 11:47:39,Civis Cafe Canteen,-1690.0,29590.39,False
TRANSFER,Current,2025-02-14 18:28:08,To HUF,10000.0,39590.39,False
CARD_PAYMENT,Current,2025-02-14 07:55:53,Cocacolahbcmagyaror,-500.0,39090.39,False
CARD_PAYMENT,Current,2025-02-14 17:02:11,Vir Var Dekor,-6000.0,33090.39,False
TRANSFER,Current,2025-02-15 18:15:48,Transfer from Revolut user,100000.0,133090.39,False
TRANSFER,Current,2025-02-15 18:17:24,To Anett Moldován,-99000.0,33397.39,False
TRANSFER,Current,2025-02-16 00:32:50,To HUF,15000.0,48397.39,False
CARD_PAYMENT,Current,2025-02-14 09:18:22,Liliput Játékvilág,-19289.0,29108.39,False
CARD_PAYMENT,Current,2025-02-15 22:47:48,Spontán Café & Lounge,-1200.0,27908.39,False
CARD_PAYMENT,Current,2025-02-15 21:33:37,Péterfia Rock Söröző,-690.0,27218.39,False
TRANSFER,Current,2025-02-16 11:52:03,To HUF,35000.0,62218.39,False
CARD_PAYMENT,Current,2025-02-15 09:18:09,PENNY,-5151.0,57067.39,False
CARD_PAYMENT,Current,2025-02-15 15:43:35,Nemzeti Dohánybolt,-1700.0,55367.39,False
CARD_PAYMENT,Current,2025-02-16 00:43:05,MAXILine Töltőállomás,-10068.0,45299.39,False
TOPUP,Current,2025-02-17 17:14:15,Top-Up by *7109,4000.0,49299.39,False
CARD_PAYMENT,Current,2025-02-17 16:37:55,Lidl,-5069.0,44230.39,False
CARD_PAYMENT,Current,2025-02-18 21:57:13,Spotify,-1090.0,43140.39,False
CARD_PAYMENT,Current,2025-02-18 15:45:40,HELLA AUTOTECHNIK NOVA s.r.o.,-430.0,42710.39,False
CARD_PAYMENT,Current,2025-02-18 09:35:21,Debreceni Egyetem,-470.0,42240.39,False
CARD_PAYMENT,Current,2025-02-18 11:37:31,"Diagnostic Sport, Lifestyle and Therapy Center",-13000.0,29240.39,False
CARD_PAYMENT,Current,2025-02-20 07:49:24,Cocacolahbcmagyaror,-500.0,28740.39,False
TRANSFER,Current,2025-02-21 19:52:35,Transfer to Revolut user,-3000.0,25740.39,False
TRANSFER,Current,2025-02-21 19:53:48,Transfer from Revolut user,3000.0,28740.39,False
CARD_PAYMENT,Current,2025-02-21 13:31:11,Viger Katalin E.v.,-1420.0,27320.39,False
CARD_PAYMENT,Current,2025-02-21 19:43:47,Apolló Mozi,-3300.0,24020.39,False
TRANSFER,Current,2025-02-22 15:36:57,To Lilla Salanki,-4500.0,19488.89,False
TRANSFER,Current,2025-02-23 15:11:56,To HUF,50000.0,69488.89,False
TRANSFER,Current,2025-02-23 15:16:11,To HUF Temp,-30000.0,39488.89,False
TRANSFER,Current,2025-02-24 09:28:48,Transfer from Revolut user,2063.34,41552.23,False
CARD_PAYMENT,Current,2025-02-23 15:14:00,MAXILine Töltőállomás,-20819.0,20733.23,False
CARD_PAYMENT,Current,2025-02-24 08:57:19,Apple,-6190.0,14543.23,False
CARD_PAYMENT,Current,2025-02-24 17:25:48,HELLA AUTOTECHNIK NOVA s.r.o.,-430.0,14113.23,False
CARD_PAYMENT,Current,2025-02-24 15:47:56,Simple,-896.0,13217.23,False
CARD_PAYMENT,Current,2025-02-25 12:27:37,Twitch,-2018.22,11199.01,False
CARD_PAYMENT,Current,2025-02-25 12:46:56,Coop,-1997.0,9202.01,False
CARD_PAYMENT,Current,2025-02-24 23:11:57,De Agra'r Kapu,-2200.0,7002.01,False
CARD_PAYMENT,Current,2025-02-25 17:51:18,Simple,-209.0,6793.01,False
TRANSFER,Current,2025-02-26 20:03:06,To HUF,10000.0,16793.01,False
TRANSFER,Current,2025-02-26 20:08:09,Transfer from Revolut user,8000.0,24793.01,False
TRANSFER,Current,2025-02-26 22:05:30,Transfer from Revolut user,2000.0,26793.01,False
CARD_PAYMENT,Current,2025-02-26 20:08:10,KFC,-9700.0,17093.01,False
CARD_PAYMENT,Current,2025-02-27 12:20:38,Civis Cafe Canteen,-2014.0,15079.01,False
TRANSFER,Current,2025-02-28 09:05:40,Transfer to Revolut user,-2000.0,13079.01,False
CARD_PAYMENT,Current,2025-02-27 08:01:04,Cocacolahbcmagyaror,-500.0,12579.01,False
CARD_PAYMENT,Current,2025-02-27 14:17:32,Cocacolahbcmagyaror,-500.0,12079.01,False
TRANSFER,Current,2025-02-28 12:09:35,To HUF,50000.0,62079.01,False
TRANSFER,Current,2025-02-28 12:40:34,HUF → Revolut X,-20167.49,41911.52,False
CARD_PAYMENT,Current,2025-02-28 12:09:43,Coinbase,-20165.72,21745.8,False
TRANSFER,Current,2025-02-28 20:06:46,Transfer from Revolut user,2000.0,23745.8,False
TRANSFER,Current,2025-02-28 20:07:37,Transfer to Revolut user,-2000.0,21745.8,False
CARD_PAYMENT,Current,2025-02-28 20:07:18,KFC,-5970.0,15775.8,False
CARD_PAYMENT,Current,2025-03-02 12:47:41,Nemzeti Dohánybolt,-1800.0,13975.8,False
TRANSFER,Current,2025-03-03 18:22:01,Transfer to Revolut user,-0.4,13975.4,False
TRANSFER,Current,2025-03-03 18:22:10,Transfer to Revolut user,-0.4,13975.0,False
EXCHANGE,Current,2025-03-03 18:27:14,Exchange to HUF,19.84,13994.84,False
TRANSFER,Current,2025-03-03 19:02:49,To HUF,15000.0,28994.84,False
TRANSFER,Current,2025-03-03 19:38:11,To LEVENTE NANDOR POLGARI,-900.0,28088.54,False
CARD_PAYMENT,Current,2025-03-03 19:03:10,Fizz,-14780.0,13308.54,False
CARD_PAYMENT,Current,2025-03-03 15:46:42,Simple,-1002.0,12306.54,False
TRANSFER,Current,2025-03-04 15:41:12,Transfer to Revolut user,-6000.0,6306.54,False
TRANSFER,Current,2025-03-04 16:48:48,To HUF,5000.0,11306.54,False
CARD_PAYMENT,Current,2025-03-04 20:29:32,GLS,-6480.0,4826.54,False
CARD_PAYMENT,Current,2025-03-04 13:10:04,Simple,-242.0,4584.54,False
TOPUP,Current,2025-03-06 10:56:22,Top-Up by *7109,128816.0,133400.54,False
TRANSFER,Current,2025-03-06 13:16:23,Transfer from Revolut user,127.64,133528.18,False
EXCHANGE,Current,2025-03-06 13:16:55,Exchange to HUF,50493.91,184022.09,False
TRANSFER,Current,2025-03-06 13:17:14,Transfer to Revolut user,-50500.0,133522.09,False
TRANSFER,Current,2025-03-06 14:22:39,Transfer to Revolut user,-5000.0,128522.09,False
TRANSFER,Current,2025-03-06 14:24:19,Transfer from Revolut user,5000.0,133522.09,False
CARD_PAYMENT,Current,2025-03-06 11:00:18,Trading 212,-20154.39,113367.7,False
CARD_PAYMENT,Current,2025-03-06 10:59:24,Trading 212,-20161.69,93206.01,False
TRANSFER,Current,2025-03-06 18:37:27,Transfer from Revolut user,3700.0,96906.01,False
TOPUP,Current,2025-03-06 18:37:49,Top-Up by *7109,11300.0,108206.01,False
TRANSFER,Current,2025-03-07 10:38:27,To LEVENTE NANDOR POLGARI,-1000.0,107199.01,False
CARD_PAYMENT,Current,2025-03-07 17:26:40,Nemzeti Dohánybolt,-1800.0,105399.01,False
TRANSFER,Current,2025-03-08 14:10:40,Transfer from Revolut user,7000.0,112399.01,False
TRANSFER,Current,2025-03-08 18:02:21,Transfer from Revolut user,50000.0,162399.01,False
CARD_PAYMENT,Current,2025-03-07 21:32:27,Burger King,-5270.0,157129.01,False
TRANSFER,Current,2025-03-09 11:01:03,To HUF Temp,-50000.0,107129.01,False
CARD_PAYMENT,Current,2025-03-08 10:20:51,Uveges Nikolett,-16499.0,90630.01,False
TRANSFER,Current,2025-03-09 11:46:31,To Anett Moldován,-20000.0,70490.01,False
TRANSFER,Current,2025-03-09 11:46:43,To Zéti Polgári,-20000.0,50350.01,False
TRANSFER,Current,2025-03-09 11:46:56,To HUF,50000.0,100350.01,False
CARD_PAYMENT,Current,2025-03-08 10:11:37,Simple,-244.0,100106.01,False
TRANSFER,Current,2025-03-09 15:53:25,Transfer from Revolut user,2000.0,102106.01,False
CARD_PAYMENT,Current,2025-03-09 10:42:35,Viger Katalin E.v.,-1430.0,100676.01,False
CARD_PAYMENT,Current,2025-03-09 15:10:31,Nagy Beki Pekseg,-400.0,100276.01,False
TOPUP,Current,2025-03-10 12:04:49,Top-Up by *7109,185000.0,285276.01,False
TRANSFER,Current,2025-03-10 12:06:21,To HUF Temp,-230000.0,55276.01,False
TRANSFER,Current,2025-03-10 15:48:11,To HUF,330000.0,385276.01,False
TRANSFER,Current,2025-03-10 15:48:34,To Savings Account,-300000.0,85276.01,False
TRANSFER,Current,2025-03-10 20:16:09,To Mark Fodor,-2000.0,83262.01,False
CARD_PAYMENT,Current,2025-03-09 22:18:45,Árukereső,-15490.0,67772.01,False
CARD_PAYMENT,Current,2025-03-10 15:04:16,barion,-11380.0,56392.01,False
CARD_PAYMENT,Current,2025-03-11 17:52:26,Simple,-209.0,56183.01,False
CARD_PAYMENT,Current,2025-03-13 17:07:43,Nemzeti Dohánybolt,-1800.0,54383.01,False
TRANSFER,Current,2025-03-14 09:59:01,Transfer to Revolut user,-15000.0,39383.01,False
CARD_PAYMENT,Current,2025-03-13 21:39:31,eMAG,-3348.0,36035.01,False
TRANSFER,Current,2025-03-14 15:28:15,Transfer from Revolut user,50000.0,86035.01,False
TRANSFER,Current,2025-03-14 15:28:37,To Anett Moldován,-49500.0,36188.51,False
TRANSFER,Current,2025-03-15 00:22:09,Transfer from Revolut user,1500.0,37688.51,False
TRANSFER,Current,2025-03-15 00:24:55,From Savings Account,10000.0,47688.51,False
TRANSFER,Current,2025-03-15 00:26:08,Transfer from Revolut user,1500.0,49188.51,False
TOPUP,Current,2025-03-15 01:10:28,Top-Up by *7109,26000.0,75188.51,False
TRANSFER,Current,2025-03-15 01:13:23,To Savings Account,-10000.0,65188.51,False
CARD_PAYMENT,Current,2025-03-14 22:55:44,Wolt,-5096.0,60092.51,False
CARD_PAYMENT,Current,2025-03-14 21:12:09,StatiON Bowling Debrecen,-4422.0,55670.51,False
CARD_PAYMENT,Current,2025-03-14 21:52:29,Nemzeti Dohánybolt,-2400.0,53270.51,False
CARD_PAYMENT,Current,2025-03-14 21:49:17,Nemzeti Dohánybolt,-3000.0,50270.51,False
TRANSFER,Current,2025-03-15 14:50:00,From Savings Account,30000.0,80270.51,False
TRANSFER,Current,2025-03-15 14:58:05,Transfer from Revolut user,2500.0,82770.51,False
CARD_PAYMENT,Current,2025-03-15 14:57:47,KFC,-4690.0,78080.51,False
CARD_PAYMENT,Current,2025-03-15 21:37:30,MAXILine Töltőállomás,-19223.0,58857.51,False
CARD_PAYMENT,Current,2025-03-15 00:25:02,StatiON Bowling Debrecen,-29600.0,29257.51,False
TRANSFER,Current,2025-03-17 13:06:22,From Savings Account,70000.0,99257.51,False
CARD_PAYMENT,Current,2025-03-17 10:18:31,Charlotte Tilbury,-16887.56,82369.95,False
TRANSFER,Current,2025-03-18 12:59:57,Transfer from Revolut user,1000.0,83369.95,False
CARD_PAYMENT,Current,2025-03-17 15:51:22,Simple,-816.0,82553.95,False
CARD_PAYMENT,Current,2025-03-18 21:57:19,Spotify,-1090.0,81463.95,False
CARD_PAYMENT,Current,2025-03-18 12:00:56,Simple,-595.0,80868.95,False
CARD_PAYMENT,Current,2025-03-18 17:52:42,Simple,-209.0,80659.95,False
TRANSFER,Current,2025-03-20 17:49:58,Transfer from Revolut user,54.91,80714.86,False
EXCHANGE,Current,2025-03-20 17:50:40,Exchange to HUF,21681.15,102396.01,False
CARD_PAYMENT,Current,2025-03-19 11:48:37,Nemzeti Dohánybolt,-1900.0,100496.01,False
CARD_PAYMENT,Current,2025-03-20 17:56:40,Tippmixpro,-2000.0,98496.01,False
CARD_PAYMENT,Current,2025-03-20 17:12:12,Tippmixpro,-25000.0,73496.01,False
TRANSFER,Current,2025-03-21 07:51:06,To Anett Moldován,-40000.0,33216.01,False
TRANSFER,Current,2025-03-21 22:18:05,Transfer from Revolut user,4000.0,37216.01,False
TOPUP,Current,2025-03-21 22:47:18,Top-Up by *4479,10000.0,47216.01,False
CARD_PAYMENT,Current,2025-03-21 13:11:11,Allegro,-6010.0,41206.01,False
CARD_PAYMENT,Current,2025-03-21 13:14:12,Schenopol,-3705.0,37501.01,False
EXCHANGE,Current,2025-03-22 23:47:48,Exchange to HUF,102450.72,138927.22,False
TRANSFER,Current,2025-03-22 23:49:32,Transfer to Revolut user,-49000.0,89927.22,False
CARD_PAYMENT,Current,2025-03-21 22:18:00,McDonald's,-5690.0,84237.22,False
CARD_PAYMENT,Current,2025-03-22 16:54:31,Nemzeti Dohánybolt,-11728.0,72509.22,False
CARD_PAYMENT,Current,2025-03-22 13:52:22,Nagy Beki Pekseg,-1330.0,71179.22,False
CARD_PAYMENT,Current,2025-03-22 10:38:33,"Diagnostic Sport, Lifestyle and Therapy Center",-13000.0,58179.22,False
CARD_PAYMENT,Current,2025-03-23 17:52:51,Tippmixpro,-4000.0,54179.22,False
TRANSFER,Current,2025-03-24 12:28:42,Transfer from Revolut user,4000.0,58179.22,False
CARD_PAYMENT,Current,2025-03-24 18:02:30,The Box Donut Debrecen,-2580.0,55599.22,False
CARD_PAYMENT,Current,2025-03-24 07:57:34,Apple,-6190.0,49409.22,False
TRANSFER,Current,2025-03-25 13:39:08,Transfer to Revolut user,-2300.0,47109.22,False
TRANSFER,Current,2025-03-25 16:52:01,Transfer to Revolut user,-1000.0,46109.22,False
TRANSFER,Current,2025-03-25 16:52:34,Transfer from Revolut user,1000.0,47109.22,False
CARD_PAYMENT,Current,2025-03-25 17:55:34,Both-Dega Büfe,-1220.0,45889.22,False
CARD_PAYMENT,Current,2025-03-25 07:49:40,HELLA AUTOTECHNIK NOVA s.r.o.,-430.0,45459.22,False
CARD_PAYMENT,Current,2025-03-25 12:27:39,Twitch,-2001.16,43458.06,False
CARD_PAYMENT,Current,2025-03-26 07:56:43,Civis Cafe Canteen,-2631.0,40827.06,False
TOPUP,Current,2025-03-27 11:50:47,Top-Up by *7109,6560.0,47387.06,False
CARD_PAYMENT,Current,2025-03-26 07:58:01,1605021531 Gfa It,-500.0,46887.06,False
ATM,Current,2025-03-29 16:10:40,"Cash at Sarand, Nagy U. 50.",-13000.0,33887.06,False
TRANSFER,Current,2025-03-31 14:14:39,Transfer from Revolut user,10000.0,43887.06,False
TRANSFER,Current,2025-03-31 14:15:04,Transfer to Revolut user,-10000.0,33887.06,False
CARD_PAYMENT,Current,2025-03-30 19:43:09,Apollo Cinema,-3520.0,30367.06,False
CARD_PAYMENT,Current,2025-03-31 19:33:38,Nemzeti Dohánybolt,-1800.0,28567.06,False
TRANSFER,Current,2025-04-02 10:25:26,From Savings Account,20000.0,48567.06,False
CARD_PAYMENT,Current,2025-04-01 11:38:43,KFC,-2490.0,46077.06,False
CARD_PAYMENT,Current,2025-04-01 11:35:03,Simple,-577.0,45500.06,False
CARD_PAYMENT,Current,2025-04-02 10:33:44,Techsend,-22480.0,23020.06,False
CARD_PAYMENT,Current,2025-04-04 07:44:34,Civis Cafe Canteen,-350.0,22670.06,False
CARD_PAYMENT,Current,2025-04-04 11:55:47,Civis Cafe Canteen,-1827.0,20843.06,False
CARD_PAYMENT,Current,2025-04-04 07:45:43,1605021531 Gfa It,-500.0,20343.06,False
CARD_PAYMENT,Current,2025-04-05 16:42:41,Crunchyroll,-300.0,,False
CARD_PAYMENT,Current,2025-04-03 23:39:16,McDonald's,-3250.0,17093.06,False
CARD_PAYMENT,Current,2025-04-05 22:02:49,Megálló Pizzéria és Ételbár,-11270.0,5823.06,False
TRANSFER,Current,2025-04-06 19:20:23,From Savings Account,20000.0,25823.06,False
CARD_PAYMENT,Current,2025-04-06 20:03:34,KFC,-3980.0,21843.06,False
CARD_PAYMENT,Current,2025-04-06 20:35:42,McDonald's,-820.0,21023.06,False
TRANSFER,Current,2025-04-07 23:36:29,Transfer from Revolut user,110000.0,131023.06,False
TRANSFER,Current,2025-04-07 23:37:03,To Anett Moldován,-109250.0,21008.31,False
TOPUP,Current,2025-04-08 13:48:50,Top-Up by *7109,175000.0,196008.31,False
TRANSFER,Current,2025-04-08 13:50:35,To Savings Account,-40000.0,156008.31,False
TRANSFER,Current,2025-04-08 15:06:06,To Savings Account,-100000.0,56008.31,False
CARD_PAYMENT,Current,2025-04-08 07:40:35,Civis Cafe Canteen,-1319.0,54689.31,False
CARD_PAYMENT,Current,2025-04-08 12:32:00,Civis Cafe Canteen,-3916.0,50773.31,False
TRANSFER,Current,2025-04-08 17:06:35,Transfer to Revolut user,-3000.0,47773.31,False
TRANSFER,Current,2025-04-09 12:12:05,Transfer from Revolut user,1480.0,49253.31,False
TRANSFER,Current,2025-04-09 12:12:00,Transfer from Revolut user,820.0,50073.31,False
CARD_PAYMENT,Current,2025-04-08 07:42:41,1605021531 Gfa It,-500.0,49573.31,False
TOPUP,Current,2025-04-10 10:49:25,Top-Up by *7109,237000.0,286573.31,False
TRANSFER,Current,2025-04-10 10:50:33,To HUF Holidays,-150000.0,136573.31,False
TRANSFER,Current,2025-04-10 10:51:40,To HUF Holidays,-50000.0,86573.31,False
TRANSFER,Current,2025-04-10 10:52:05,To HUF,60000.0,146573.31,False
TRANSFER,Current,2025-04-10 10:53:57,Transfer to Revolut user,-60000.0,86573.31,False
CARD_PAYMENT,Current,2025-04-09 11:37:50,Coop,-873.0,85700.31,False
CARD_PAYMENT,Current,2025-04-09 12:11:27,Simple,-793.0,84907.31,False
CARD_PAYMENT,Current,2025-04-09 10:25:39,Benu,-1849.0,83058.31,False
CARD_PAYMENT,Current,2025-04-09 10:34:25,MAXILine Töltőállomás,-22585.0,60473.31,False
CARD_PAYMENT,Current,2025-04-10 18:32:32,Popbeni Kft.,-420.0,60053.31,False
CARD_PAYMENT,Current,2025-04-10 08:37:58,Coop,-1746.0,58307.31,False
CARD_PAYMENT,Current,2025-04-10 15:56:45,Nemzeti Dohánybolt,-1700.0,56607.31,False
CARD_PAYMENT,Current,2025-04-11 07:02:29,Nemzeti Dohánybolt,-1018.0,55589.31,False
TOPUP,Current,2025-04-12 14:06:48,Top-Up by *7109,4000.0,59589.31,False
TRANSFER,Current,2025-04-12 14:08:13,Transfer from Revolut user,4149.6,63738.91,False
TRANSFER,Current,2025-04-12 14:08:16,Transfer from Revolut user,3838.0,67576.91,False
CARD_PAYMENT,Current,2025-04-12 13:57:46,Wolt,-4149.6,63427.31,False
CARD_PAYMENT,Current,2025-04-12 13:56:56,Wolt,-3838.0,59589.31,False
CARD_PAYMENT,Current,2025-04-12 22:32:36,Sheldon's,-2499.0,57090.31,False
CARD_PAYMENT,Current,2025-04-12 13:12:07,Reál,-2860.0,54230.31,False
CARD_PAYMENT,Current,2025-04-12 13:15:04,Nemzeti Dohánybolt,-2125.0,52105.31,False
CARD_PAYMENT,Current,2025-04-12 16:43:16,Crunchyroll,-2450.0,49655.31,False
CARD_PAYMENT,Current,2025-04-14 17:05:43,Reál,-1227.0,48428.31,False
CARD_PAYMENT,Current,2025-04-15 13:37:44,Coop,-1346.0,47082.31,False
CARD_PAYMENT,Current,2025-04-15 17:54:40,Simple,-209.0,46873.31,False
CARD_PAYMENT,Current,2025-04-16 20:18:07,Tesco,-3569.0,43304.31,False
CARD_PAYMENT,Current,2025-04-16 11:32:56,Nemzeti Dohánybolt,-1700.0,41604.31,False
CARD_PAYMENT,Current,2025-04-18 22:57:22,Spotify,-1090.0,40514.31,False
CARD_PAYMENT,Current,2025-04-19 11:33:14,Nemzeti Dohánybolt,-4163.0,36351.31,False
TRANSFER,Savings,2025-01-05 15:16:16,To HUF Dentist,50000.0,50000.0,False
TRANSFER,Savings,2025-01-20 12:58:03,To HUF Temp,450000.0,500000.0,False
TRANSFER,Savings,2025-01-23 14:09:04,To HUF,-15000.0,485000.0,False
TRANSFER,Savings,2025-01-26 15:49:28,To HUF,-450000.0,35000.0,False
TRANSFER,Savings,2025-02-11 10:25:45,To HUF Temp,250000.0,285000.0,False
TRANSFER,Savings,2025-02-11 10:26:00,To HUF Temp,20000.0,305000.0,False
TRANSFER,Savings,2025-02-12 20:25:12,To HUF,-35000.0,270000.0,False
TRANSFER,Savings,2025-02-14 09:20:45,To HUF,-10000.0,260000.0,False
TRANSFER,Savings,2025-02-14 18:28:08,To HUF,-10000.0,250000.0,False
TRANSFER,Savings,2025-02-14 18:28:22,Closing transaction,0.0,250000.0,False
TRANSFER,Savings,2025-02-16 00:32:50,To HUF,-15000.0,235000.0,False
TRANSFER,Savings,2025-02-16 11:52:03,To HUF,-35000.0,200000.0,False
TRANSFER,Savings,2025-02-23 15:11:56,To HUF,-50000.0,150000.0,False
TRANSFER,Savings,2025-02-23 15:16:11,To HUF Temp,30000.0,180000.0,False
TRANSFER,Savings,2025-02-26 20:03:06,To HUF,-10000.0,170000.0,False
TRANSFER,Savings,2025-02-28 12:09:35,To HUF,-50000.0,120000.0,False
TRANSFER,Savings,2025-03-03 19:02:49,To HUF,-15000.0,105000.0,False
TRANSFER,Savings,2025-03-04 16:48:48,To HUF,-5000.0,100000.0,False
TRANSFER,Savings,2025-03-09 11:01:03,To HUF Temp,50000.0,150000.0,False
TRANSFER,Savings,2025-03-09 11:46:56,To HUF,-50000.0,100000.0,False
TRANSFER,Savings,2025-03-10 12:06:21,To HUF Temp,230000.0,330000.0,False
TRANSFER,Savings,2025-03-10 15:48:11,To HUF,-330000.0,0.0,False
TRANSFER,Savings,2025-03-10 15:48:23,Closing transaction,0.0,0.0,False
TRANSFER,Savings,2025-04-10 10:50:33,To HUF Holidays,150000.0,150000.0,False
TRANSFER,Savings,2025-04-10 10:51:40,To HUF Holidays,50000.0,200000.0,False
TRANSFER,Savings,2025-04-10 10:52:05,To HUF,-60000.0,140000.0,False
TRANSFER,Deposit,2025-03-10 15:48:34,To Savings Account,300000.0,300000.0,False
TRANSFER,Deposit,2025-03-15 00:24:55,From Savings Account,-10000.0,290034.93,False
TRANSFER,Deposit,2025-03-15 01:13:23,To Savings Account,10000.0,300034.93,False
TRANSFER,Deposit,2025-03-15 14:50:00,From Savings Account,-30000.0,270043.67,False
TRANSFER,Deposit,2025-03-17 13:06:22,From Savings Account,-70000.0,200059.38,False
TRANSFER,Deposit,2025-04-02 10:25:26,From Savings Account,-20000.0,180152.55,False
TRANSFER,Deposit,2025-04-06 19:20:23,From Savings Account,-20000.0,160173.51,False
TRANSFER,Deposit,2025-04-08 13:50:35,To Savings Account,40000.0,200182.84,False
TRANSFER,Deposit,2025-04-08 15:06:06,To Savings Account,100000.0,300182.84,False
