Type,Product,Date,Description,Amount,Balance,Hide,Category
CARD_PAYMENT,Current,2025-04-30 08:47:21,Civis Cafe Canteen,-350,27866,False,Food
CARD_PAYMENT,Current,2025-04-30 07:54:29,1605021531 Gfa It,-500,27366,False,Food
CARD_PAYMENT,Current,2025-04-30 13:46:05,Coop,-1237,26129,False,Food
CARD_PAYMENT,Current,2025-04-30 15:48:36,Simple,-1297,24832,False,Uncategorized
CARD_PAYMENT,Current,2025-05-01 12:29:37,Viger Katalin E.v.,-700,24132,False,Food
TOPUP,Current,2025-05-01 21:55:08,Top-Up by *7109,6000,30132,True,Uncategorized
TRANSFER,Current,2025-05-02 18:20:15,Transfer from Revolut user,5200,35332,True,Uncategorized
CARD_PAYMENT,Current,2025-05-01 21:59:59,Steam,-6028,29304,False,Entertainment
CARD_PAYMENT,Current,2025-05-02 12:47:33,Sostozoo,-5600,13704,False,Entertainment
CARD_PAYMENT,Current,2025-04-29 17:59:24,HELL Energy,-430,13274,False,Food
TRANSFER,Current,2025-05-03 10:27:34,Transfer from Revolut user,1267,14540,True,Uncategorized
TRANSFER,Current,2025-05-03 10:30:05,Transfer to Revolut user,-1266,13274,True,Uncategorized
CARD_PAYMENT,Current,2025-05-02 16:03:51,Cocacolahbcmagyaror,-700,12574,False,Food
CARD_PAYMENT,Current,2025-05-02 16:05:10,Cocacolahbcmagyaror,-700,11874,False,Food
CARD_PAYMENT,Current,2025-05-02 18:22:41,KFC,-3000,5564,False,Food
TRANSFER,Current,2025-05-04 11:15:42,To HUF,20000,25564,True,Uncategorized
CARD_PAYMENT,Current,2025-05-04 11:19:53,Apple,-4490,21074,False,Subscriptions
EXCHANGE,Current,2025-05-05 11:41:50,Exchange to HUF,509034,528457,True,Uncategorized
TRANSFER,Current,2025-05-05 11:42:13,Transfer to Revolut user,-305000,223457,True,Uncategorized
TRANSFER,Current,2025-05-05 11:43:25,Zéti Polgári,-200000,22057,True,Uncategorized
TOPUP,Current,2025-05-05 11:48:54,Top-Up by *7109,4500,26557,True,Uncategorized
CARD_PAYMENT,Current,2025-05-04 10:55:24,Vitaminkucko,-3719,22838,True,Food
CARD_PAYMENT,Current,2025-05-05 15:09:48,Nemzeti Dohánybolt,-688,22150,False,Nemzeti Dohánybolt
CARD_PAYMENT,Current,2025-05-05 16:50:01,Both-Dega Büfe,-1500,20650,False,Food
CARD_PAYMENT,Current,2025-05-05 15:38:05,Simple,-989,19661,False,Uncategorized
TRANSFER,Current,2025-05-07 15:12:35,Transfer to Revolut user,-12000,7661,True,Uncategorized
CARD_PAYMENT,Current,2025-05-07 07:48:07,Civis Cafe Canteen,-1400,6261,False,Food
TRANSFER,Current,2025-05-08 17:33:16,Transfer from Revolut user,12000,18261,True,Uncategorized
TRANSFER,Current,2025-05-08 17:33:37,Anett Moldován,-12000,6177,False,Uncategorized
TOPUP,Current,2025-05-09 09:57:36,Top-Up by *7109,200000,206177,False,Uncategorized
TRANSFER,Current,2025-05-09 09:59:19,To HUF Holidays,-20000,186177,True,Uncategorized
TRANSFER,Current,2025-05-09 10:00:18,To Savings Account,-30000,156177,True,Uncategorized
TRANSFER,Current,2025-05-09 10:02:12,To HUF Rainy day,-60000,96177,True,Uncategorized
TRANSFER,Current,2025-05-10 20:03:56,Transfer from Revolut user,7500,103677,True,Uncategorized
CARD_PAYMENT,Current,2025-05-10 20:03:59,Wolt,-7835,95842,True,Food
CARD_PAYMENT,Current,2025-05-10 16:55:58,Simple,-325,95517,False,Uncategorized
CARD_PAYMENT,Current,2025-05-11 11:13:39,Nagy Beki Pekseg,-850,94667,False,Food
CARD_PAYMENT,Current,2025-05-12 17:45:39,Annuska fagylaltbisztró és kávézó,-3330,91337,False,Food
CARD_PAYMENT,Current,2025-05-12 19:53:01,Reál,-1957,89380,False,Food
CARD_PAYMENT,Current,2025-05-12 17:01:51,dm drogerie,-2499,86881,False,Uncategorized
CARD_PAYMENT,Current,2025-05-12 16:43:53,Crunchyroll,-2450,84431,False,Subscriptions
TRANSFER,Current,2025-05-13 20:20:49,LEVENTE NANDOR POLGARI,-30000,54221,True,Uncategorized
CARD_PAYMENT,Current,2025-05-13 23:51:31,Notino,-4020,50201,False,Uncategorized
CARD_PAYMENT,Current,2025-05-13 17:51:45,Simple,-209,49992,False,Uncategorized
CARD_PAYMENT,Current,2025-05-13 12:06:18,NAV,-5771,44221,True,Uncategorized
CARD_PAYMENT,Current,2025-05-14 07:39:03,Civis Cafe Canteen,-1850,42371,False,Food
TRANSFER,Current,2025-05-15 13:04:10,To HUF,75000,117371,True,Uncategorized
TRANSFER,Current,2025-05-16 08:45:35,Transfer from Revolut user,35800,153171,True,Uncategorized
TRANSFER,Current,2025-05-16 08:48:15,Transfer from Revolut user,10000,163171,True,Uncategorized
TRANSFER,Current,2025-05-16 08:48:30,Anett Moldován,-10000,153101,True,Uncategorized
CARD_PAYMENT,Current,2025-05-15 13:05:40,Ryanair,-73952,79149,False,Travel
TRANSFER,Current,2025-05-16 16:37:07,Anett Moldován,-2000,77135,False,Uncategorized
CARD_PAYMENT,Current,2025-05-16 17:06:21,MOL,-24397,52738,False,Uncategorized
CARD_PAYMENT,Current,2025-05-16 15:55:45,Simple,-550,52188,False,Uncategorized
CARD_PAYMENT,Current,2025-05-18 22:57:15,Spotify,-1090,51098,False,Subscriptions
TRANSFER,Current,2025-05-19 11:09:04,LEVENTE NANDOR POLGARI,-5000,46063,False,Uncategorized
CARD_PAYMENT,Current,2025-05-18 19:40:04,Nemzeti Dohánybolt,-1700,44363,False,Nemzeti Dohánybolt
TRANSFER,Current,2025-05-21 07:57:57,Transfer from Revolut user,50000,94363,True,Uncategorized
TRANSFER,Current,2025-05-21 08:01:00,Anett Moldován,-49500,44517,True,Uncategorized
CARD_PAYMENT,Current,2025-05-20 10:43:33,Debreceni Egyetem,-440,44077,False,Uncategorized
CARD_PAYMENT,Current,2025-05-21 09:15:12,Civis Cafe Canteen,-1374,42703,False,Food
TRANSFER,Current,2025-05-22 08:55:41,To HUF,108000,150703,True,Uncategorized
CARD_PAYMENT,Current,2025-05-21 09:25:08,1605021531 Gfa It,-550,150153,False,Food
TRANSFER,Current,2025-05-22 14:24:12,To HUF Holidays,-105000,45153,True,Uncategorized
TRANSFER,Current,2025-05-22 14:24:54,To HUF,3000,48153,True,Uncategorized
TRANSFER,Current,2025-05-22 14:25:04,To HUF Holidays,-6000,42153,True,Uncategorized
TRANSFER,Current,2025-05-22 22:42:27,To HUF,50000,92153,True,Uncategorized
TRANSFER,Current,2025-05-22 22:48:27,To HUF,15000,107153,True,Uncategorized
CARD_PAYMENT,Current,2025-05-23 18:22:46,KFC,-4580,102573,False,Food
TRANSFER,Current,2025-05-24 11:56:23,Transfer from Revolut user,2043,104615,True,Uncategorized
TRANSFER,Current,2025-05-24 14:55:50,Transfer to Revolut user,-1000,103615,False,Uncategorized
TRANSFER,Current,2025-05-24 14:56:21,LEVENTE NANDOR POLGARI,-3000,100594,True,Uncategorized
TOPUP,Current,2025-05-24 14:56:42,Top-Up by *7109,5500,106094,True,Uncategorized
TRANSFER,Current,2025-05-24 22:05:11,Mark Fodor,-5000,101059,False,Uncategorized
CARD_PAYMENT,Current,2025-05-24 08:59:38,Apple,-4190,94869,False,Subscriptions
TRANSFER,Current,2025-05-25 11:50:21,To HUF,60000,154869,True,Uncategorized
CARD_PAYMENT,Current,2025-05-24 17:55:58,Líra,-3591,151278,False,Uncategorized
CARD_PAYMENT,Current,2025-05-24 14:47:40,Apolló Mozi,-3300,147978,False,Entertainment
TOPUP,Current,2025-05-26 11:39:11,Top-Up by *7109,20000,167978,True,Uncategorized
CARD_PAYMENT,Current,2025-05-25 16:56:50,Vitaminkucko,-1027,166951,False,Food
CARD_PAYMENT,Current,2025-05-22 22:42:34,Adriagate,-65036,101265,False,Travel
EXCHANGE,Current,2025-05-26 20:49:21,Exchange to HUF,6,101271,True,Uncategorized
TRANSFER,Current,2025-05-27 06:09:07,Transfer from Revolut user,110000,211271,True,Uncategorized
TRANSFER,Current,2025-05-27 08:42:04,Anett Moldován,-109000,101508,True,Uncategorized
CARD_PAYMENT,Current,2025-05-27 12:26:06,1605021531 Gfa It,-550,100958,False,Food
CARD_PAYMENT,Current,2025-05-28 10:19:26,Arriva,-13781,87039,False,Travel
TRANSFER,Current,2025-05-29 17:38:03,Transfer to Revolut user,-3000,84039,False,Uncategorized
TRANSFER,Current,2025-05-29 18:01:15,Transfer from Revolut user,4000,88039,True,Uncategorized
CARD_PAYMENT,Current,2025-05-29 17:52:49,Wolt,-3049,84990,False,Food
CARD_PAYMENT,Current,2025-05-29 17:59:26,eduna.hu,-12980,72010,False,Uncategorized
CARD_PAYMENT,Current,2025-05-29 19:55:06,MOB Söröző Kávézó,-6160,65850,False,Entertainment
CARD_PAYMENT,Current,2025-05-29 21:27:02,MOB Söröző Kávézó,-850,65000,False,Entertainment
CARD_PAYMENT,Current,2025-05-29 22:23:47,MOB Söröző Kávézó,-1920,63080,False,Entertainment
CARD_PAYMENT,Current,2025-05-29 19:12:23,Nemzeti Mobilfizetési,-480,62600,False,Uncategorized
CARD_PAYMENT,Current,2025-05-29 18:12:40,Nemzeti Dohánybolt,-2125,60475,False,Nemzeti Dohánybolt
TRANSFER,Savings,2025-05-04 11:15:42,To HUF,-20000,180000,True,Uncategorized
TRANSFER,Savings,2025-05-09 09:59:19,To HUF Holidays,20000,200000,True,Uncategorized
TRANSFER,Savings,2025-05-09 10:02:12,To HUF Rainy day,60000,260000,True,Uncategorized
TRANSFER,Savings,2025-05-15 13:04:10,To HUF,-75000,185000,True,Uncategorized
TRANSFER,Savings,2025-05-22 08:55:41,To HUF,-108000,77000,True,Uncategorized
TRANSFER,Savings,2025-05-22 14:24:12,To HUF Holidays,105000,182000,True,Uncategorized
TRANSFER,Savings,2025-05-22 14:24:54,To HUF,-3000,179000,True,Uncategorized
TRANSFER,Savings,2025-05-22 14:25:04,To HUF Holidays,6000,185000,True,Uncategorized
TRANSFER,Savings,2025-05-22 22:42:27,To HUF,-50000,135000,True,Uncategorized
TRANSFER,Savings,2025-05-22 22:48:27,To HUF,-15000,120000,True,Uncategorized
TRANSFER,Savings,2025-05-25 11:50:21,To HUF,-60000,60000,True,Uncategorized
TRANSFER,Deposit,2025-05-09 10:00:18,To Savings Account,30000,330451,False,Uncategorized
FEE,Current,2025-01-01 02:06:13,Premium plan fee,-3000,100213,False,Subscriptions
TRANSFER,Current,2025-01-01 17:22:08,Transfer to Revolut user,-100000,213,False,Uncategorized
TRANSFER,Current,2025-01-01 17:24:44,Transfer from Revolut user,995000,995213,True,Uncategorized
EXCHANGE,Current,2025-01-01 17:26:51,Exchange to EUR,-995000,213,False,Uncategorized
TRANSFER,Current,2025-01-01 21:07:33,Transfer from Revolut user,140000,140213,True,Uncategorized
TRANSFER,Current,2025-01-02 09:10:25,To Anett Moldován,-139000,240,False,Uncategorized
TOPUP,Current,2025-01-02 17:47:49,Top-Up by *7109,100000,100240,False,Uncategorized
TRANSFER,Current,2025-01-03 00:44:04,To LEVENTE NANDOR POLGARI,-3000,97219,False,Uncategorized
TOPUP,Current,2025-01-03 00:44:18,Top-Up by *7109,5300,102519,False,Uncategorized
CARD_PAYMENT,Current,2025-01-02 18:16:56,KFC,-2390,100129,False,Food
TRANSFER,Current,2025-01-04 13:51:19,Transfer to Revolut user,-3700,96429,False,Uncategorized
CARD_PAYMENT,Current,2025-01-03 11:19:35,Magyar Posta,-30970,65459,False,Uncategorized
CARD_PAYMENT,Current,2025-01-03 20:07:39,Bartók Csemege,-2239,63220,False,Uncategorized
CARD_REFUND,Current,2025-01-04 01:00:00,Delfinbúvár,2870,66090,False,Uncategorized
TRANSFER,Current,2025-01-05 14:34:44,Transfer from Revolut user,50000,116090,True,Uncategorized
TRANSFER,Current,2025-01-05 15:16:16,To HUF Dentist,-50000,66090,True,Uncategorized
TOPUP,Current,2025-01-08 12:08:57,Top-Up by *7109,20000,86090,False,Uncategorized
CARD_PAYMENT,Current,2025-01-07 16:42:26,MAXILine Töltőállomás,-10002,76088,False,Gas
CARD_PAYMENT,Current,2025-01-08 17:04:47,Simple,-613,75475,False,Uncategorized
CARD_PAYMENT,Current,2025-01-08 17:53:02,Magyar Posta,-7170,68305,False,Uncategorized
TOPUP,Current,2025-01-10 11:48:42,Top-Up by *7109,241357,309662,False,Uncategorized
TRANSFER,Current,2025-01-10 11:51:41,Transfer from Revolut user,29972,339634,True,Uncategorized
TRANSFER,Current,2025-01-10 23:04:20,Transfer to Revolut user,-60000,279634,False,Uncategorized
TRANSFER,Current,2025-01-10 23:05:18,Transfer from Revolut user,60000,339634,True,Uncategorized
EXCHANGE,Current,2025-01-10 23:06:31,Exchange to EUR,-60000,279634,False,Uncategorized
TRANSFER,Current,2025-01-10 23:13:43,To LEVENTE NANDOR POLGARI,-30000,249424,False,Uncategorized
TOPUP,Current,2025-01-10 23:16:27,Top-Up by *7109,10660,260084,False,Uncategorized
CARD_PAYMENT,Current,2025-01-10 11:39:29,Xiaomi Official,-14490,245594,False,Uncategorized
CARD_PAYMENT,Current,2025-01-10 11:50:28,Airbnb,-59943,185651,False,Travel
CARD_PAYMENT,Current,2025-01-10 12:45:43,ANRO épületdíszétés,-4390,181261,False,Uncategorized
TRANSFER,Current,2025-01-11 17:15:43,Transfer from Revolut user,20000,201261,True,Uncategorized
TOPUP,Current,2025-01-12 18:24:15,Top-Up by *7109,6000,207261,False,Uncategorized
TRANSFER,Current,2025-01-12 18:24:33,Transfer to Revolut user,-6000,201261,False,Uncategorized
TOPUP,Current,2025-01-12 23:45:51,Top-Up by *7109,82280,283541,False,Uncategorized
CARD_PAYMENT,Current,2025-01-12 23:44:21,Alza,-82280,201261,False,Uncategorized
CARD_PAYMENT,Current,2025-01-13 14:23:15,Trading 212,-41687,159574,False,Uncategorized
TOPUP,Current,2025-01-14 15:11:32,Top-Up by *7109,70000,229574,False,Uncategorized
CARD_PAYMENT,Current,2025-01-14 15:32:06,Vir Var Dekor,-3000,226574,False,Uncategorized
CARD_PAYMENT,Current,2025-01-14 17:09:36,Nemzeti Dohánybolt,-1700,224874,False,Nemzeti Dohánybolt
CARD_PAYMENT,Current,2025-01-14 12:14:41,Nemzeti Mobilfizetési,-480,224394,False,Uncategorized
CARD_PAYMENT,Current,2025-01-14 13:35:31,Coop,-857,223537,False,Food
CARD_PAYMENT,Current,2025-01-14 15:15:29,Nemzeti Dohánybolt,-949,222588,False,Nemzeti Dohánybolt
TRANSFER,Current,2025-01-15 22:57:46,Transfer from Revolut user,3500,226088,True,Uncategorized
CARD_PAYMENT,Current,2025-01-15 19:56:37,Wolt,-6739,219349,False,Food
TRANSFER,Current,2025-01-16 17:35:53,To Zéti Polgári,-10000,209279,False,Uncategorized
CARD_PAYMENT,Current,2025-01-16 09:36:44,Civis Cafe Canteen,-115,209164,False,Food
CARD_PAYMENT,Current,2025-01-17 20:58:14,Wolt,-3729,205435,False,Food
CARD_PAYMENT,Current,2025-01-17 16:28:00,Nemzeti Dohánybolt,-1800,203635,False,Nemzeti Dohánybolt
CARD_PAYMENT,Current,2025-01-17 16:36:30,CBA,-2346,201289,False,Uncategorized
CARD_PAYMENT,Current,2025-01-18 21:57:17,Spotify,-1090,200199,False,Subscriptions
TRANSFER,Current,2025-01-19 20:28:12,Transfer to Revolut user,-2800,197399,False,Uncategorized
TRANSFER,Current,2025-01-19 20:28:34,Transfer to Revolut user,-25000,172399,False,Uncategorized
TRANSFER,Current,2025-01-19 20:28:52,Transfer from Revolut user,25000,197399,True,Uncategorized
TRANSFER,Current,2025-01-19 20:28:59,Transfer from Revolut user,2800,200199,True,Uncategorized
TOPUP,Current,2025-01-20 12:55:43,Top-Up by *7109,450000,650199,False,Uncategorized
TRANSFER,Current,2025-01-20 12:58:03,To HUF Temp,-450000,200199,True,Uncategorized
CARD_PAYMENT,Current,2025-01-19 10:38:57,ALDI,-564,199635,False,Food
CARD_PAYMENT,Current,2025-01-19 16:07:56,Nemzeti Dohánybolt,-2400,197235,False,Nemzeti Dohánybolt
CARD_PAYMENT,Current,2025-01-21 18:33:35,Hamburger Bár,-580,196655,False,Uncategorized
TRANSFER,Current,2025-01-23 11:11:48,Transfer to Revolut user,-15000,181655,False,Uncategorized
TRANSFER,Current,2025-01-23 14:04:54,Transfer from Revolut user,2500,184155,True,Uncategorized
TRANSFER,Current,2025-01-23 14:09:04,To HUF,15000,199155,True,Uncategorized
TRANSFER,Current,2025-01-23 14:22:13,Transfer from Revolut user,2000,201155,True,Uncategorized
CARD_PAYMENT,Current,2025-01-23 14:11:39,Wolt,-5366,195788,False,Food
TRANSFER,Current,2025-01-24 17:28:59,Transfer to Revolut user,-60000,135788,False,Uncategorized
TRANSFER,Current,2025-01-24 18:27:59,Transfer to Revolut user,-5000,130788,False,Uncategorized
TOPUP,Current,2025-01-24 18:51:06,Top-Up by *7109,65000,195788,False,Uncategorized
CARD_PAYMENT,Current,2025-01-24 08:58:23,Apple,-6190,189598,False,Subscriptions
CARD_PAYMENT,Current,2025-01-24 17:31:18,Nemzeti Mobilfizetési,-560,189038,False,Uncategorized
CARD_PAYMENT,Current,2025-01-24 18:51:55,ALDI,-3861,185177,False,Food
CARD_PAYMENT,Current,2025-01-24 18:54:37,Nemzeti Dohánybolt,-1800,183377,False,Nemzeti Dohánybolt
TRANSFER,Current,2025-01-25 23:13:21,To Zéti Polgári,-77500,105335,False,Uncategorized
CARD_PAYMENT,Current,2025-01-25 12:27:35,Twitch,-2044,103270,False,Subscriptions
CARD_PAYMENT,Current,2025-01-25 12:47:51,Nemzeti Mobilfizetési,-480,102790,False,Uncategorized
TRANSFER,Current,2025-01-26 15:49:28,To HUF,450000,552790,True,Uncategorized
TRANSFER,Current,2025-01-26 15:50:06,To Anett Moldován,-547000,1961,False,Uncategorized
CARD_PAYMENT,Current,2025-01-25 12:57:44,McDonald's,-1490,471,False,Food
EXCHANGE,Current,2025-01-27 09:10:23,Exchange to HUF,81009,81480,False,Uncategorized
TRANSFER,Current,2025-01-27 23:57:51,Transfer from Revolut user,140000,221480,True,Uncategorized
TRANSFER,Current,2025-01-28 08:46:56,To Anett Moldován,-138500,82010,False,Uncategorized
CARD_PAYMENT,Current,2025-01-27 18:40:18,McDonald's,-2260,79750,False,Food
CARD_PAYMENT,Current,2025-01-28 15:12:28,Dallmayr,-260,79490,False,Uncategorized
CARD_PAYMENT,Current,2025-01-28 13:33:50,Debreceni Egyetem,-530,78960,False,Uncategorized
CARD_PAYMENT,Current,2025-01-29 17:54:11,Nemzeti Dohánybolt,-2179,76781,False,Nemzeti Dohánybolt
FEE,Current,2025-02-01 02:22:59,Premium plan fee,-3000,73781,False,Subscriptions
CARD_PAYMENT,Current,2025-02-04 15:50:58,Amazon Prime,-1900,71881,False,Subscriptions
CARD_PAYMENT,Current,2025-02-06 17:42:12,Nemzeti Dohánybolt,-1088,70793,False,Nemzeti Dohánybolt
CARD_PAYMENT,Current,2025-02-05 19:07:07,Steam,-5234,65559,False,Entertainment
CARD_PAYMENT,Current,2025-02-05 22:09:37,Nemzeti Dohánybolt,-2147,63412,False,Nemzeti Dohánybolt
CARD_PAYMENT,Current,2025-02-06 18:05:08,McDonald's,-1690,61722,False,Food
TRANSFER,Current,2025-02-09 16:58:05,To LEVENTE NANDOR POLGARI,-41000,20435,False,Uncategorized
TOPUP,Current,2025-02-10 11:58:34,Top-Up by *7109,308846,329281,False,Uncategorized
CARD_PAYMENT,Current,2025-02-10 12:00:06,Union Vienna Insurance Group,-27929,301352,False,Uncategorized
TRANSFER,Current,2025-02-11 10:25:45,To HUF Temp,-250000,51352,True,Uncategorized
TRANSFER,Current,2025-02-11 10:26:00,To HUF Temp,-20000,31352,True,Uncategorized
CARD_PAYMENT,Current,2025-02-10 16:24:16,Wok n’ Go,-3800,27552,False,Food
CARD_PAYMENT,Current,2025-02-11 07:55:15,Civis Cafe Canteen,-450,27102,False,Food
CARD_PAYMENT,Current,2025-02-10 10:49:44,Viger Katalin E.v.,-1200,25902,False,Food
CARD_PAYMENT,Current,2025-02-11 11:48:25,Civis Cafe Canteen,-3118,22784,False,Food
TOPUP,Current,2025-02-11 19:40:52,Top-Up by *7109,9462,32246,False,Uncategorized
TRANSFER,Current,2025-02-11 19:41:29,Transfer to Revolut user,-9400,22846,False,Uncategorized
CARD_PAYMENT,Current,2025-02-11 21:14:57,Tippmixpro,-1500,21346,False,Entertainment
CARD_PAYMENT,Current,2025-02-11 17:13:01,Coop,-1106,20240,False,Food
TRANSFER,Current,2025-02-12 15:32:54,Transfer to Revolut user,-5000,15240,False,Uncategorized
TOPUP,Current,2025-02-12 15:33:06,Top-Up by *7109,5000,20240,False,Uncategorized
TRANSFER,Current,2025-02-12 20:25:12,To HUF,35000,55240,True,Uncategorized
TRANSFER,Current,2025-02-12 20:26:08,To Zéti Polgári,-28000,27044,False,Uncategorized
TOPUP,Current,2025-02-12 23:34:34,Top-Up by *4479,12800,39844,False,Uncategorized
CARD_PAYMENT,Current,2025-02-12 12:34:03,Nemzeti Dohánybolt,-2379,37465,False,Nemzeti Dohánybolt
CARD_PAYMENT,Current,2025-02-12 21:29:28,McDonald's,-2110,35355,False,Food
TRANSFER,Current,2025-02-13 16:32:31,To Zéti Polgári,-6000,29313,False,Uncategorized
TRANSFER,Current,2025-02-14 09:20:45,To HUF,10000,39313,True,Uncategorized
CARD_PAYMENT,Current,2025-02-13 14:10:31,Simple,-7289,32024,False,Uncategorized
CARD_PAYMENT,Current,2025-02-14 07:54:34,Civis Cafe Canteen,-744,31280,False,Food
CARD_PAYMENT,Current,2025-02-14 11:47:39,Civis Cafe Canteen,-1690,29590,False,Food
TRANSFER,Current,2025-02-14 18:28:08,To HUF,10000,39590,True,Uncategorized
CARD_PAYMENT,Current,2025-02-14 07:55:53,Cocacolahbcmagyaror,-500,39090,False,Food
CARD_PAYMENT,Current,2025-02-14 17:02:11,Vir Var Dekor,-6000,33090,False,Uncategorized
TRANSFER,Current,2025-02-15 18:15:48,Transfer from Revolut user,100000,133090,True,Uncategorized
TRANSFER,Current,2025-02-15 18:17:24,To Anett Moldován,-99000,33397,False,Uncategorized
TRANSFER,Current,2025-02-16 00:32:50,To HUF,15000,48397,True,Uncategorized
CARD_PAYMENT,Current,2025-02-14 09:18:22,Liliput Játékvilág,-19289,29108,False,Uncategorized
CARD_PAYMENT,Current,2025-02-15 22:47:48,Spontán Café & Lounge,-1200,27908,False,Uncategorized
CARD_PAYMENT,Current,2025-02-15 21:33:37,Péterfia Rock Söröző,-690,27218,False,Uncategorized
TRANSFER,Current,2025-02-16 11:52:03,To HUF,35000,62218,True,Uncategorized
CARD_PAYMENT,Current,2025-02-15 09:18:09,PENNY,-5151,57067,False,Food
CARD_PAYMENT,Current,2025-02-15 15:43:35,Nemzeti Dohánybolt,-1700,55367,False,Nemzeti Dohánybolt
CARD_PAYMENT,Current,2025-02-16 00:43:05,MAXILine Töltőállomás,-10068,45299,False,Gas
TOPUP,Current,2025-02-17 17:14:15,Top-Up by *7109,4000,49299,False,Uncategorized
CARD_PAYMENT,Current,2025-02-17 16:37:55,Lidl,-5069,44230,False,Food
CARD_PAYMENT,Current,2025-02-18 21:57:13,Spotify,-1090,43140,False,Subscriptions
CARD_PAYMENT,Current,2025-02-18 15:45:40,HELLA AUTOTECHNIK NOVA s.r.o.,-430,42710,False,Food
CARD_PAYMENT,Current,2025-02-18 09:35:21,Debreceni Egyetem,-470,42240,False,Uncategorized
CARD_PAYMENT,Current,2025-02-18 11:37:31,"Diagnostic Sport, Lifestyle and Therapy Center",-13000,29240,False,Uncategorized
CARD_PAYMENT,Current,2025-02-20 07:49:24,Cocacolahbcmagyaror,-500,28740,False,Food
TRANSFER,Current,2025-02-21 19:52:35,Transfer to Revolut user,-3000,25740,False,Uncategorized
TRANSFER,Current,2025-02-21 19:53:48,Transfer from Revolut user,3000,28740,True,Uncategorized
CARD_PAYMENT,Current,2025-02-21 13:31:11,Viger Katalin E.v.,-1420,27320,False,Food
CARD_PAYMENT,Current,2025-02-21 19:43:47,Apolló Mozi,-3300,24020,False,Entertainment
TRANSFER,Current,2025-02-22 15:36:57,To Lilla Salanki,-4500,19489,False,Uncategorized
TRANSFER,Current,2025-02-23 15:11:56,To HUF,50000,69489,True,Uncategorized
TRANSFER,Current,2025-02-23 15:16:11,To HUF Temp,-30000,39489,True,Uncategorized
TRANSFER,Current,2025-02-24 09:28:48,Transfer from Revolut user,2063,41552,True,Uncategorized
CARD_PAYMENT,Current,2025-02-23 15:14:00,MAXILine Töltőállomás,-20819,20733,False,Gas
CARD_PAYMENT,Current,2025-02-24 08:57:19,Apple,-6190,14543,False,Subscriptions
CARD_PAYMENT,Current,2025-02-24 17:25:48,HELLA AUTOTECHNIK NOVA s.r.o.,-430,14113,False,Food
CARD_PAYMENT,Current,2025-02-24 15:47:56,Simple,-896,13217,False,Uncategorized
CARD_PAYMENT,Current,2025-02-25 12:27:37,Twitch,-2018,11199,False,Subscriptions
CARD_PAYMENT,Current,2025-02-25 12:46:56,Coop,-1997,9202,False,Food
CARD_PAYMENT,Current,2025-02-24 23:11:57,De Agra'r Kapu,-2200,7002,False,Uncategorized
CARD_PAYMENT,Current,2025-02-25 17:51:18,Simple,-209,6793,False,Uncategorized
TRANSFER,Current,2025-02-26 20:03:06,To HUF,10000,16793,True,Uncategorized
TRANSFER,Current,2025-02-26 20:08:09,Transfer from Revolut user,8000,24793,True,Uncategorized
TRANSFER,Current,2025-02-26 22:05:30,Transfer from Revolut user,2000,26793,True,Uncategorized
CARD_PAYMENT,Current,2025-02-26 20:08:10,KFC,-9700,17093,False,Food
CARD_PAYMENT,Current,2025-02-27 12:20:38,Civis Cafe Canteen,-2014,15079,False,Food
TRANSFER,Current,2025-02-28 09:05:40,Transfer to Revolut user,-2000,13079,False,Uncategorized
CARD_PAYMENT,Current,2025-02-27 08:01:04,Cocacolahbcmagyaror,-500,12579,False,Food
CARD_PAYMENT,Current,2025-02-27 14:17:32,Cocacolahbcmagyaror,-500,12079,False,Food
TRANSFER,Current,2025-02-28 12:09:35,To HUF,50000,62079,True,Uncategorized
TRANSFER,Current,2025-02-28 12:40:34,HUF → Revolut X,-20167,41912,False,Uncategorized
CARD_PAYMENT,Current,2025-02-28 12:09:43,Coinbase,-20166,21746,False,Uncategorized
TRANSFER,Current,2025-02-28 20:06:46,Transfer from Revolut user,2000,23746,True,Uncategorized
TRANSFER,Current,2025-02-28 20:07:37,Transfer to Revolut user,-2000,21746,False,Uncategorized
CARD_PAYMENT,Current,2025-02-28 20:07:18,KFC,-5970,15776,False,Food
CARD_PAYMENT,Current,2025-03-02 12:47:41,Nemzeti Dohánybolt,-1800,13976,False,Nemzeti Dohánybolt
TRANSFER,Current,2025-03-03 18:22:01,Transfer to Revolut user,0,13975,False,Uncategorized
TRANSFER,Current,2025-03-03 18:22:10,Transfer to Revolut user,0,13975,False,Uncategorized
EXCHANGE,Current,2025-03-03 18:27:14,Exchange to HUF,20,13995,False,Uncategorized
TRANSFER,Current,2025-03-03 19:02:49,To HUF,15000,28995,True,Uncategorized
TRANSFER,Current,2025-03-03 19:38:11,To LEVENTE NANDOR POLGARI,-900,28089,False,Uncategorized
CARD_PAYMENT,Current,2025-03-03 19:03:10,Fizz,-14780,13309,False,Uncategorized
CARD_PAYMENT,Current,2025-03-03 15:46:42,Simple,-1002,12307,False,Uncategorized
TRANSFER,Current,2025-03-04 15:41:12,Transfer to Revolut user,-6000,6307,False,Uncategorized
TRANSFER,Current,2025-03-04 16:48:48,To HUF,5000,11307,True,Uncategorized
CARD_PAYMENT,Current,2025-03-04 20:29:32,GLS,-6480,4827,False,Uncategorized
CARD_PAYMENT,Current,2025-03-04 13:10:04,Simple,-242,4585,False,Uncategorized
TOPUP,Current,2025-03-06 10:56:22,Top-Up by *7109,128816,133401,False,Uncategorized
TRANSFER,Current,2025-03-06 13:16:23,Transfer from Revolut user,128,133528,True,Uncategorized
EXCHANGE,Current,2025-03-06 13:16:55,Exchange to HUF,50494,184022,False,Uncategorized
TRANSFER,Current,2025-03-06 13:17:14,Transfer to Revolut user,-50500,133522,False,Uncategorized
TRANSFER,Current,2025-03-06 14:22:39,Transfer to Revolut user,-5000,128522,False,Uncategorized
TRANSFER,Current,2025-03-06 14:24:19,Transfer from Revolut user,5000,133522,True,Uncategorized
CARD_PAYMENT,Current,2025-03-06 11:00:18,Trading 212,-20154,113368,False,Uncategorized
CARD_PAYMENT,Current,2025-03-06 10:59:24,Trading 212,-20162,93206,False,Uncategorized
TRANSFER,Current,2025-03-06 18:37:27,Transfer from Revolut user,3700,96906,True,Uncategorized
TOPUP,Current,2025-03-06 18:37:49,Top-Up by *7109,11300,108206,False,Uncategorized
TRANSFER,Current,2025-03-07 10:38:27,To LEVENTE NANDOR POLGARI,-1000,107199,False,Uncategorized
CARD_PAYMENT,Current,2025-03-07 17:26:40,Nemzeti Dohánybolt,-1800,105399,False,Nemzeti Dohánybolt
TRANSFER,Current,2025-03-08 14:10:40,Transfer from Revolut user,7000,112399,True,Uncategorized
TRANSFER,Current,2025-03-08 18:02:21,Transfer from Revolut user,50000,162399,True,Uncategorized
CARD_PAYMENT,Current,2025-03-07 21:32:27,Burger King,-5270,157129,False,Uncategorized
TRANSFER,Current,2025-03-09 11:01:03,To HUF Temp,-50000,107129,True,Uncategorized
CARD_PAYMENT,Current,2025-03-08 10:20:51,Uveges Nikolett,-16499,90630,False,Uncategorized
TRANSFER,Current,2025-03-09 11:46:31,To Anett Moldován,-20000,70490,False,Uncategorized
TRANSFER,Current,2025-03-09 11:46:43,To Zéti Polgári,-20000,50350,False,Uncategorized
TRANSFER,Current,2025-03-09 11:46:56,To HUF,50000,100350,True,Uncategorized
CARD_PAYMENT,Current,2025-03-08 10:11:37,Simple,-244,100106,False,Uncategorized
TRANSFER,Current,2025-03-09 15:53:25,Transfer from Revolut user,2000,102106,True,Uncategorized
CARD_PAYMENT,Current,2025-03-09 10:42:35,Viger Katalin E.v.,-1430,100676,False,Food
CARD_PAYMENT,Current,2025-03-09 15:10:31,Nagy Beki Pekseg,-400,100276,False,Food
TOPUP,Current,2025-03-10 12:04:49,Top-Up by *7109,185000,285276,False,Uncategorized
TRANSFER,Current,2025-03-10 12:06:21,To HUF Temp,-230000,55276,True,Uncategorized
TRANSFER,Current,2025-03-10 15:48:11,To HUF,330000,385276,True,Uncategorized
TRANSFER,Current,2025-03-10 15:48:34,To Savings Account,-300000,85276,True,Uncategorized
TRANSFER,Current,2025-03-10 20:16:09,To Mark Fodor,-2000,83262,False,Uncategorized
CARD_PAYMENT,Current,2025-03-09 22:18:45,Árukereső,-15490,67772,False,Uncategorized
CARD_PAYMENT,Current,2025-03-10 15:04:16,barion,-11380,56392,False,Uncategorized
CARD_PAYMENT,Current,2025-03-11 17:52:26,Simple,-209,56183,False,Uncategorized
CARD_PAYMENT,Current,2025-03-13 17:07:43,Nemzeti Dohánybolt,-1800,54383,False,Nemzeti Dohánybolt
TRANSFER,Current,2025-03-14 09:59:01,Transfer to Revolut user,-15000,39383,False,Uncategorized
CARD_PAYMENT,Current,2025-03-13 21:39:31,eMAG,-3348,36035,False,Uncategorized
TRANSFER,Current,2025-03-14 15:28:15,Transfer from Revolut user,50000,86035,True,Uncategorized
TRANSFER,Current,2025-03-14 15:28:37,To Anett Moldován,-49500,36189,False,Uncategorized
TRANSFER,Current,2025-03-15 00:22:09,Transfer from Revolut user,1500,37689,True,Uncategorized
TRANSFER,Current,2025-03-15 00:24:55,From Savings Account,10000,47689,True,Uncategorized
TRANSFER,Current,2025-03-15 00:26:08,Transfer from Revolut user,1500,49189,True,Uncategorized
TOPUP,Current,2025-03-15 01:10:28,Top-Up by *7109,26000,75189,False,Uncategorized
TRANSFER,Current,2025-03-15 01:13:23,To Savings Account,-10000,65189,True,Uncategorized
CARD_PAYMENT,Current,2025-03-14 22:55:44,Wolt,-5096,60093,False,Food
CARD_PAYMENT,Current,2025-03-14 21:12:09,StatiON Bowling Debrecen,-4422,55671,False,Uncategorized
CARD_PAYMENT,Current,2025-03-14 21:52:29,Nemzeti Dohánybolt,-2400,53271,False,Nemzeti Dohánybolt
CARD_PAYMENT,Current,2025-03-14 21:49:17,Nemzeti Dohánybolt,-3000,50271,False,Nemzeti Dohánybolt
TRANSFER,Current,2025-03-15 14:50:00,From Savings Account,30000,80271,True,Uncategorized
TRANSFER,Current,2025-03-15 14:58:05,Transfer from Revolut user,2500,82771,True,Uncategorized
CARD_PAYMENT,Current,2025-03-15 14:57:47,KFC,-4690,78081,False,Food
CARD_PAYMENT,Current,2025-03-15 21:37:30,MAXILine Töltőállomás,-19223,58858,False,Gas
CARD_PAYMENT,Current,2025-03-15 00:25:02,StatiON Bowling Debrecen,-29600,29258,False,Uncategorized
TRANSFER,Current,2025-03-17 13:06:22,From Savings Account,70000,99258,True,Uncategorized
CARD_PAYMENT,Current,2025-03-17 10:18:31,Charlotte Tilbury,-16888,82370,False,Uncategorized
TRANSFER,Current,2025-03-18 12:59:57,Transfer from Revolut user,1000,83370,True,Uncategorized
CARD_PAYMENT,Current,2025-03-17 15:51:22,Simple,-816,82554,False,Uncategorized
CARD_PAYMENT,Current,2025-03-18 21:57:19,Spotify,-1090,81464,False,Subscriptions
CARD_PAYMENT,Current,2025-03-18 12:00:56,Simple,-595,80869,False,Uncategorized
CARD_PAYMENT,Current,2025-03-18 17:52:42,Simple,-209,80660,False,Uncategorized
TRANSFER,Current,2025-03-20 17:49:58,Transfer from Revolut user,55,80715,True,Uncategorized
EXCHANGE,Current,2025-03-20 17:50:40,Exchange to HUF,21681,102396,False,Uncategorized
CARD_PAYMENT,Current,2025-03-19 11:48:37,Nemzeti Dohánybolt,-1900,100496,False,Nemzeti Dohánybolt
CARD_PAYMENT,Current,2025-03-20 17:56:40,Tippmixpro,-2000,98496,False,Entertainment
CARD_PAYMENT,Current,2025-03-20 17:12:12,Tippmixpro,-25000,73496,False,Entertainment
TRANSFER,Current,2025-03-21 07:51:06,To Anett Moldován,-40000,33216,False,Uncategorized
TRANSFER,Current,2025-03-21 22:18:05,Transfer from Revolut user,4000,37216,True,Uncategorized
TOPUP,Current,2025-03-21 22:47:18,Top-Up by *4479,10000,47216,False,Uncategorized
CARD_PAYMENT,Current,2025-03-21 13:11:11,Allegro,-6010,41206,False,Uncategorized
CARD_PAYMENT,Current,2025-03-21 13:14:12,Schenopol,-3705,37501,False,Uncategorized
EXCHANGE,Current,2025-03-22 23:47:48,Exchange to HUF,102451,138927,False,Uncategorized
TRANSFER,Current,2025-03-22 23:49:32,Transfer to Revolut user,-49000,89927,False,Uncategorized
CARD_PAYMENT,Current,2025-03-21 22:18:00,McDonald's,-5690,84237,False,Food
CARD_PAYMENT,Current,2025-03-22 16:54:31,Nemzeti Dohánybolt,-11728,72509,False,Nemzeti Dohánybolt
CARD_PAYMENT,Current,2025-03-22 13:52:22,Nagy Beki Pekseg,-1330,71179,False,Food
CARD_PAYMENT,Current,2025-03-22 10:38:33,"Diagnostic Sport, Lifestyle and Therapy Center",-13000,58179,False,Uncategorized
CARD_PAYMENT,Current,2025-03-23 17:52:51,Tippmixpro,-4000,54179,False,Entertainment
TRANSFER,Current,2025-03-24 12:28:42,Transfer from Revolut user,4000,58179,True,Uncategorized
CARD_PAYMENT,Current,2025-03-24 18:02:30,The Box Donut Debrecen,-2580,55599,False,Uncategorized
CARD_PAYMENT,Current,2025-03-24 07:57:34,Apple,-6190,49409,False,Subscriptions
TRANSFER,Current,2025-03-25 13:39:08,Transfer to Revolut user,-2300,47109,False,Uncategorized
TRANSFER,Current,2025-03-25 16:52:01,Transfer to Revolut user,-1000,46109,True,Uncategorized
TRANSFER,Current,2025-03-25 16:52:34,Transfer from Revolut user,1000,47109,True,Uncategorized
CARD_PAYMENT,Current,2025-03-25 17:55:34,Both-Dega Büfe,-1220,45889,False,Food
CARD_PAYMENT,Current,2025-03-25 07:49:40,HELLA AUTOTECHNIK NOVA s.r.o.,-430,45459,False,Food
CARD_PAYMENT,Current,2025-03-25 12:27:39,Twitch,-2001,43458,False,Subscriptions
CARD_PAYMENT,Current,2025-03-26 07:56:43,Civis Cafe Canteen,-2631,40827,False,Food
TOPUP,Current,2025-03-27 11:50:47,Top-Up by *7109,6560,47387,False,Uncategorized
CARD_PAYMENT,Current,2025-03-26 07:58:01,1605021531 Gfa It,-500,46887,False,Food
ATM,Current,2025-03-29 16:10:40,"Cash at Sarand, Nagy U. 50.",-13000,33887,False,Uncategorized
TRANSFER,Current,2025-03-31 14:14:39,Transfer from Revolut user,10000,43887,True,Uncategorized
TRANSFER,Current,2025-03-31 14:15:04,Transfer to Revolut user,-10000,33887,True,Uncategorized
CARD_PAYMENT,Current,2025-03-30 19:43:09,Apollo Cinema,-3520,30367,False,Entertainment
CARD_PAYMENT,Current,2025-03-31 19:33:38,Nemzeti Dohánybolt,-1800,28567,False,Nemzeti Dohánybolt
TRANSFER,Current,2025-04-02 10:25:26,From Savings Account,20000,48567,True,Uncategorized
CARD_PAYMENT,Current,2025-04-01 11:38:43,KFC,-2490,46077,False,Food
CARD_PAYMENT,Current,2025-04-01 11:35:03,Simple,-577,45500,False,Uncategorized
CARD_PAYMENT,Current,2025-04-02 10:33:44,Techsend,-22480,23020,False,Uncategorized
CARD_PAYMENT,Current,2025-04-04 07:44:34,Civis Cafe Canteen,-350,22670,False,Food
CARD_PAYMENT,Current,2025-04-04 11:55:47,Civis Cafe Canteen,-1827,20843,False,Food
CARD_PAYMENT,Current,2025-04-04 07:45:43,1605021531 Gfa It,-500,20343,False,Food
CARD_PAYMENT,Current,2025-04-03 23:39:16,McDonald's,-3250,17093,False,Food
CARD_PAYMENT,Current,2025-04-05 22:02:49,Megálló Pizzéria és Ételbár,-1200,5823,False,Uncategorized
TRANSFER,Current,2025-04-06 19:20:23,From Savings Account,20000,25823,True,Uncategorized
CARD_PAYMENT,Current,2025-04-06 20:03:34,KFC,-2500,21843,False,Food
CARD_PAYMENT,Current,2025-04-06 20:35:42,McDonald's,-820,21023,True,Food
TRANSFER,Current,2025-04-07 23:36:29,Transfer from Revolut user,110000,131023,True,Uncategorized
TRANSFER,Current,2025-04-07 23:37:03,To Anett Moldován,-109250,21008,True,Uncategorized
TOPUP,Current,2025-04-08 13:48:50,Top-Up by *7109,175000,196008,False,Uncategorized
TRANSFER,Current,2025-04-08 13:50:35,To Savings Account,-40000,156008,True,Uncategorized
TRANSFER,Current,2025-04-08 15:06:06,To Savings Account,-100000,56008,True,Uncategorized
CARD_PAYMENT,Current,2025-04-08 07:40:35,Civis Cafe Canteen,-1319,54689,False,Food
CARD_PAYMENT,Current,2025-04-08 12:32:00,Civis Cafe Canteen,-3916,50773,False,Food
TRANSFER,Current,2025-04-08 17:06:35,Transfer to Revolut user,-3000,47773,False,Uncategorized
TRANSFER,Current,2025-04-09 12:12:05,Transfer from Revolut user,1480,49253,True,Uncategorized
TRANSFER,Current,2025-04-09 12:12:00,Transfer from Revolut user,820,50073,True,Uncategorized
CARD_PAYMENT,Current,2025-04-08 07:42:41,1605021531 Gfa It,-500,49573,False,Food
TOPUP,Current,2025-04-10 10:49:25,Top-Up by *7109,237000,286573,False,Uncategorized
TRANSFER,Current,2025-04-10 10:50:33,To HUF Holidays,-150000,136573,True,Uncategorized
TRANSFER,Current,2025-04-10 10:51:40,To HUF Holidays,-50000,86573,True,Uncategorized
TRANSFER,Current,2025-04-10 10:52:05,To HUF,60000,146573,True,Uncategorized
TRANSFER,Current,2025-04-10 10:53:57,Transfer to Revolut user,-60000,86573,True,Uncategorized
CARD_PAYMENT,Current,2025-04-09 11:37:50,Coop,-873,85700,False,Food
CARD_PAYMENT,Current,2025-04-09 12:11:27,Simple,-793,84907,False,Uncategorized
CARD_PAYMENT,Current,2025-04-09 10:25:39,Benu,-1849,83058,True,Uncategorized
CARD_PAYMENT,Current,2025-04-09 10:34:25,MAXILine Töltőállomás,-22585,60473,False,Gas
CARD_PAYMENT,Current,2025-04-10 18:32:32,Popbeni Kft.,-420,60053,False,Uncategorized
CARD_PAYMENT,Current,2025-04-10 08:37:58,Coop,-1746,58307,False,Food
CARD_PAYMENT,Current,2025-04-10 15:56:45,Nemzeti Dohánybolt,-1700,56607,False,Nemzeti Dohánybolt
CARD_PAYMENT,Current,2025-04-11 07:02:29,Nemzeti Dohánybolt,-1018,55589,False,Nemzeti Dohánybolt
TOPUP,Current,2025-04-12 14:06:48,Top-Up by *7109,4000,59589,True,Uncategorized
TRANSFER,Current,2025-04-12 14:08:13,Transfer from Revolut user,4150,63739,True,Uncategorized
TRANSFER,Current,2025-04-12 14:08:16,Transfer from Revolut user,3838,67577,True,Uncategorized
CARD_PAYMENT,Current,2025-04-12 13:57:46,Wolt,-4150,63427,True,Food
CARD_PAYMENT,Current,2025-04-12 13:56:56,Wolt,-3838,59589,True,Food
CARD_PAYMENT,Current,2025-04-12 22:32:36,Sheldon's,-2499,57090,False,Uncategorized
CARD_PAYMENT,Current,2025-04-12 13:12:07,Reál,-2860,54230,False,Food
CARD_PAYMENT,Current,2025-04-12 13:15:04,Nemzeti Dohánybolt,-2125,52105,True,Nemzeti Dohánybolt
CARD_PAYMENT,Current,2025-04-12 16:43:16,Crunchyroll,-2450,49655,False,Subscriptions
CARD_PAYMENT,Current,2025-04-14 17:05:43,Reál,-1227,48428,False,Food
CARD_PAYMENT,Current,2025-04-15 13:37:44,Coop,-1346,47082,False,Food
CARD_PAYMENT,Current,2025-04-15 17:54:40,Simple,-209,46873,False,Uncategorized
CARD_PAYMENT,Current,2025-04-16 20:18:07,Tesco,-3569,43304,False,Food
CARD_PAYMENT,Current,2025-04-16 11:32:56,Nemzeti Dohánybolt,-1700,41604,False,Nemzeti Dohánybolt
CARD_PAYMENT,Current,2025-04-18 22:57:22,Spotify,-1090,40514,False,Subscriptions
CARD_PAYMENT,Current,2025-04-19 11:33:14,Nemzeti Dohánybolt,-1000,36351,False,Nemzeti Dohánybolt
TRANSFER,Savings,2025-01-05 15:16:16,To HUF Dentist,50000,50000,True,Uncategorized
TRANSFER,Savings,2025-01-20 12:58:03,To HUF Temp,450000,500000,True,Uncategorized
TRANSFER,Savings,2025-01-23 14:09:04,To HUF,-15000,485000,True,Uncategorized
TRANSFER,Savings,2025-01-26 15:49:28,To HUF,-450000,35000,True,Uncategorized
TRANSFER,Savings,2025-02-11 10:25:45,To HUF Temp,250000,285000,True,Uncategorized
TRANSFER,Savings,2025-02-11 10:26:00,To HUF Temp,20000,305000,True,Uncategorized
TRANSFER,Savings,2025-02-12 20:25:12,To HUF,-35000,270000,True,Uncategorized
TRANSFER,Savings,2025-02-14 09:20:45,To HUF,-10000,260000,True,Uncategorized
TRANSFER,Savings,2025-02-14 18:28:08,To HUF,-10000,250000,True,Uncategorized
TRANSFER,Savings,2025-02-14 18:28:22,Closing transaction,0,250000,False,Uncategorized
TRANSFER,Savings,2025-02-16 00:32:50,To HUF,-15000,235000,True,Uncategorized
TRANSFER,Savings,2025-02-16 11:52:03,To HUF,-35000,200000,True,Uncategorized
TRANSFER,Savings,2025-02-23 15:11:56,To HUF,-50000,150000,True,Uncategorized
TRANSFER,Savings,2025-02-23 15:16:11,To HUF Temp,30000,180000,True,Uncategorized
TRANSFER,Savings,2025-02-26 20:03:06,To HUF,-10000,170000,True,Uncategorized
TRANSFER,Savings,2025-02-28 12:09:35,To HUF,-50000,120000,True,Uncategorized
TRANSFER,Savings,2025-03-03 19:02:49,To HUF,-15000,105000,True,Uncategorized
TRANSFER,Savings,2025-03-04 16:48:48,To HUF,-5000,100000,True,Uncategorized
TRANSFER,Savings,2025-03-09 11:01:03,To HUF Temp,50000,150000,True,Uncategorized
TRANSFER,Savings,2025-03-09 11:46:56,To HUF,-50000,100000,True,Uncategorized
TRANSFER,Savings,2025-03-10 12:06:21,To HUF Temp,230000,330000,True,Uncategorized
TRANSFER,Savings,2025-03-10 15:48:11,To HUF,-330000,0,True,Uncategorized
TRANSFER,Savings,2025-03-10 15:48:23,Closing transaction,0,0,False,Uncategorized
TRANSFER,Savings,2025-04-10 10:50:33,To HUF Holidays,150000,150000,True,Uncategorized
TRANSFER,Savings,2025-04-10 10:51:40,To HUF Holidays,50000,200000,True,Uncategorized
TRANSFER,Savings,2025-04-10 10:52:05,To HUF,-60000,140000,True,Uncategorized
TRANSFER,Deposit,2025-03-10 15:48:34,To Savings Account,300000,300000,False,Uncategorized
TRANSFER,Deposit,2025-03-15 00:24:55,From Savings Account,-10000,290035,False,Uncategorized
TRANSFER,Deposit,2025-03-15 01:13:23,To Savings Account,10000,300035,False,Uncategorized
TRANSFER,Deposit,2025-03-15 14:50:00,From Savings Account,-30000,270044,False,Uncategorized
TRANSFER,Deposit,2025-03-17 13:06:22,From Savings Account,-70000,200059,False,Uncategorized
TRANSFER,Deposit,2025-04-02 10:25:26,From Savings Account,-20000,180153,True,Uncategorized
TRANSFER,Deposit,2025-04-06 19:20:23,From Savings Account,-20000,160174,True,Uncategorized
TRANSFER,Deposit,2025-04-08 13:50:35,To Savings Account,40000,200183,False,Uncategorized
TRANSFER,Deposit,2025-04-08 15:06:06,To Savings Account,100000,300183,False,Uncategorized
TRANSFER,Savings,2025-06-12 08:16:10,To HUF,-60000,0,True,Uncategorized
TRANSFER,Savings,2025-06-12 08:16:22,Closing transaction,0,0,True,Uncategorized
TRANSFER,Deposit,2025-06-10 09:27:02,From Savings Account,-21000,309757,True,Uncategorized
TRANSFER,Deposit,2025-06-12 08:18:56,To Savings Account,21000,330774,True,Uncategorized
CARD_PAYMENT,Current,2025-05-31 21:05:08,Tippmixpro,-1500,58975,False,Entertainment
CARD_PAYMENT,Current,2025-05-31 19:42:12,KFC,-2490,56485,False,Food
TRANSFER,Current,2025-06-01 14:34:37,Transfer to Revolut user,-2000,54485,False,Uncategorized
CARD_PAYMENT,Current,2025-05-31 23:10:09,McDonald's,-6040,48445,False,Food
CARD_PAYMENT,Current,2025-05-31 23:10:56,McDonald's,-4025,44420,True,Food
CARD_PAYMENT,Current,2025-05-31 23:29:53,Nemzeti Dohánybolt,-899,43521,False,Nemzeti Dohánybolt
CARD_PAYMENT,Current,2025-06-01 23:56:58,Epic Games Store,-749,42772,False,Entertainment
CARD_PAYMENT,Current,2025-06-01 22:18:37,Steam,-369,42400,False,Entertainment
CARD_PAYMENT,Current,2025-06-03 09:17:38,Simple,-244,42156,False,Uncategorized
CARD_PAYMENT,Current,2025-06-03 07:34:13,HELL Energy,-430,41726,False,Food
CARD_PAYMENT,Current,2025-06-04 11:37:09,Civis Cafe Canteen,-2376,39350,False,Food
CARD_PAYMENT,Current,2025-06-04 09:26:49,1605021531 Gfa It,-550,38800,False,Food
CARD_PAYMENT,Current,2025-06-04 16:36:00,Auchan,-2928,35872,False,Food
CARD_PAYMENT,Current,2025-06-05 19:53:16,Tippmixpro,-1500,34372,False,Entertainment
CARD_PAYMENT,Current,2025-06-06 19:25:48,Smash Burger & Beer Bar Debrecen,-5980,28392,False,Food
CARD_PAYMENT,Current,2025-06-06 18:13:41,Nemzeti Dohánybolt,-2100,26292,False,Nemzeti Dohánybolt
TRANSFER,Current,2025-06-07 16:26:17,Transfer from Revolut user,2000,28292,True,Uncategorized
TRANSFER,Current,2025-06-07 16:26:51,Transfer from Revolut user,900,29192,True,Uncategorized
TOPUP,Current,2025-06-07 16:36:02,Top-Up by *7109,4000,33192,True,Uncategorized
CARD_PAYMENT,Current,2025-06-07 16:31:56,Harap Lak,-4270,26922,False,Food
CARD_PAYMENT,Current,2025-06-07 18:53:13,Harap Lak,-1400,25522,False,Food
CARD_PAYMENT,Current,2025-06-07 14:11:37,Kerekestelepi Termálfürdő és Kemping,-5400,20122,False,Entertainment
CARD_PAYMENT,Current,2025-06-08 00:54:12,Tippmixpro,-3000,17122,False,Entertainment
CARD_PAYMENT,Current,2025-06-08 09:39:35,Tippmixpro,-17121,1,False,Entertainment
TRANSFER,Current,2025-06-10 09:27:02,From Savings Account,21000,21001,True,Uncategorized
TRANSFER,Current,2025-06-10 09:27:39,Transfer to Revolut user,-20000,1001,True,Uncategorized
TOPUP,Current,2025-06-10 11:11:38,Top-Up by *7109,265000,266001,False,Uncategorized
TRANSFER,Current,2025-06-10 15:22:47,Transfer from Revolut user,26000,292001,True,Uncategorized
TRANSFER,Current,2025-06-10 16:15:08,Zéti Polgári,-25500,266322,True,Uncategorized
ATM,Current,2025-06-10 18:11:56,"Cash at Sarand, Nagy U. 50.",-50000,216322,False,Uncategorized
TRANSFER,Current,2025-06-12 08:16:10,To HUF,60000,276322,True,Uncategorized
TRANSFER,Current,2025-06-12 08:18:56,To Savings Account,-21000,255322,True,Uncategorized
EXCHANGE,Current,2025-06-12 08:51:05,Exchange to EUR,-150610,104712,False,Uncategorized
TRANSFER,Current,2025-06-12 17:16:02,Mark Fodor,-1000,103705,False,Uncategorized
TRANSFER,Current,2025-06-12 20:46:11,Transfer to Revolut user,-10000,93705,False,Uncategorized
CARD_PAYMENT,Current,2025-06-12 09:19:11,Civis Cafe Canteen,-427,93278,False,Food
CARD_PAYMENT,Current,2025-06-12 16:18:22,Nagy Beki Pekseg,-2190,91088,True,Food
TRANSFER,Current,2025-06-13 13:13:25,Mark Fodor,-5300,85751,True,Uncategorized
TOPUP,Current,2025-06-13 17:10:19,Top-Up by *7109,10000,95751,True,Uncategorized
TRANSFER,Current,2025-06-13 18:37:24,Transfer from Revolut user,5771,101522,True,Uncategorized
CARD_PAYMENT,Current,2025-06-12 16:03:43,MOL,-3198,98324,True,Uncategorized
CARD_PAYMENT,Current,2025-06-12 08:15:06,NAV,-5771,92553,True,Uncategorized
CARD_PAYMENT,Current,2025-06-12 16:43:43,Crunchyroll,-2450,90103,False,Subscriptions
CARD_PAYMENT,Current,2025-06-13 13:30:40,Nemzeti Dohánybolt,-1227,88876,False,Nemzeti Dohánybolt
CARD_PAYMENT,Current,2025-06-14 12:52:41,Nemzeti Dohánybolt,-2492,86384,False,Nemzeti Dohánybolt
TRANSFER,Current,2025-06-15 11:43:22,Anett Moldován,-1800,84571,False,Uncategorized
TRANSFER,Current,2025-06-15 13:50:15,Anett Moldován,-2000,82557,False,Uncategorized
TOPUP,Current,2025-06-18 10:27:58,Top-Up by *7109,20000,102557,True,Uncategorized
TOPUP,Current,2025-06-18 22:11:24,Top-Up by *7109,4900,107457,True,Uncategorized
CARD_PAYMENT,Current,2025-06-18 07:37:00,Civis Cafe Canteen,-817,106640,False,Food
CARD_PAYMENT,Current,2025-06-18 22:57:20,Spotify,-1090,105550,False,Subscriptions
TRANSFER,Savings,2025-04-28 11:59:52,To HUF Holidays,60000,200000,True,Uncategorized
CARD_PAYMENT,Current,2025-04-22 07:00:43,Nagy Beki Pekseg,-1670,34681,False,Food
CARD_PAYMENT,Current,2025-04-23 07:48:28,Civis Cafe Canteen,-1147,33534,False,Food
CARD_PAYMENT,Current,2025-04-23 09:38:53,Civis Catering,-450,33084,False,Uncategorized
CARD_PAYMENT,Current,2025-04-23 15:19:27,Coop,-2379,30705,False,Food
CARD_PAYMENT,Current,2025-04-24 08:57:01,Apple,-6190,24515,False,Subscriptions
TRANSFER,Current,2025-04-25 21:30:28,Transfer from Revolut user,30000,54515,True,Uncategorized
CARD_PAYMENT,Current,2025-04-25 09:13:15,Nemzeti Dohánybolt,-2020,52495,True,Nemzeti Dohánybolt
CARD_PAYMENT,Current,2025-04-25 20:14:43,StatiON Bowling Debrecen,-1320,51175,False,Uncategorized
CARD_PAYMENT,Current,2025-04-25 16:00:32,Simple,-909,50266,False,Uncategorized
TRANSFER,Current,2025-04-26 15:51:26,Transfer from Revolut user,1640,51906,True,Uncategorized
TRANSFER,Current,2025-04-26 16:34:11,Transfer from Revolut user,30000,81906,True,Uncategorized
CARD_PAYMENT,Current,2025-04-25 15:49:35,Nemzeti Dohánybolt,-3400,78506,False,Nemzeti Dohánybolt
TOPUP,Current,2025-04-26 21:00:18,Top-Up by *7109,11000,89506,True,Uncategorized
CARD_PAYMENT,Current,2025-04-26 15:49:38,Zeusz Gyros Bar,-1600,86226,False,Uncategorized
CARD_PAYMENT,Current,2025-04-26 01:50:21,Debreczeni Csaphaz,-1920,84306,False,Uncategorized
CARD_PAYMENT,Current,2025-04-26 00:53:09,Debreczeni Csaphaz,-1920,82386,False,Uncategorized
CARD_PAYMENT,Current,2025-04-25 22:29:52,Debreczeni Csaphaz,-2460,79926,False,Uncategorized
TOPUP,Current,2025-04-27 11:48:20,Top-Up by *7109,10000,89926,True,Uncategorized
CARD_PAYMENT,Current,2025-04-26 16:39:14,Orlen,-23057,66869,False,Uncategorized
CARD_PAYMENT,Current,2025-04-26 14:41:57,HelloPay,-1300,65569,False,Uncategorized
CARD_PAYMENT,Current,2025-04-25 21:30:35,StatiON Bowling Debrecen,-6000,35969,False,Uncategorized
TOPUP,Current,2025-04-27 14:28:09,Top-Up by *7109,8000,43969,True,Uncategorized
TRANSFER,Current,2025-04-28 07:45:33,Transfer from Revolut user,110000,153969,True,Uncategorized
TRANSFER,Current,2025-04-28 11:11:56,Anett Moldován,-109200,44005,True,Uncategorized
TOPUP,Current,2025-04-28 11:47:34,Top-Up by *7109,68000,112005,False,Uncategorized
TRANSFER,Current,2025-04-28 11:59:52,To HUF Holidays,-60000,52005,True,Uncategorized
TRANSFER,Current,2025-04-28 20:51:01,Transfer from Revolut user,1790,53795,True,Uncategorized
TRANSFER,Current,2025-04-29 10:01:56,Transfer to Revolut user,-20000,33795,False,Uncategorized
CARD_PAYMENT,Current,2025-04-28 20:13:47,KFC,-1700,30215,False,Food
CARD_PAYMENT,Current,2025-04-29 09:14:18,Coop,-1999,28216,False,Food
TRANSFER,Savings,2025-06-12 08:16:17,Closing transaction,0,0,True,Uncategorized
CARD_PAYMENT,Current,2025-06-18 19:04:27,KFC,-4960,96590,False,Food
CARD_PAYMENT,Current,2025-06-18 21:52:53,Tesco,-2196,94394,False,Food
TRANSFER,Current,2025-06-19 23:26:24,Transfer from Revolut user,4000,98394,True,Uncategorized
CARD_PAYMENT,Current,2025-06-19 08:13:56,Civis Cafe Canteen,-934,97460,False,Food
CARD_PAYMENT,Current,2025-06-19 11:52:13,Civis Cafe Canteen,-2502,94958,False,Food
CARD_PAYMENT,Current,2025-06-19 19:21:21,Apollo Cinema,-4340,90618,True,Entertainment
CARD_PAYMENT,Current,2025-06-19 18:25:48,McDonald's,-720,89898,False,Food
CARD_PAYMENT,Current,2025-06-19 18:09:57,McDonald's,-4150,83748,False,Food
CARD_PAYMENT,Current,2025-06-19 16:02:47,Simple,-910,82838,False,Uncategorized
CARD_PAYMENT,Current,2025-06-19 18:54:47,Apolló Mozi,-4950,77888,False,Entertainment
